+-+-+-+-+-+-+-+-+-+-+-+-+-+-+-+-+-+-+-+-+-+-+-+-+-+-+-+-+-+-+
|         | | | | | | |       | |     | |     | |     | |   |
+-+ +-+-+ + + + + + + +-+-+-+ + +-+ +-+ +-+-+ + + +-+ + + +-+
|     | |         | | |     |   | | |   |     |   |         |
+-+-+ + +-+ +-+-+ + + +-+-+ +-+ + + +-+ +-+-+ + +-+-+-+-+-+-+
| | | | |     | |     |   |     |         | | | | |   |   | |
+ + + + + +-+-+ +-+ +-+-+ +-+ +-+-+-+-+-+ + + + + +-+ +-+ + +
|   |   |   |       |   | |   |   | |       |   |           |
+-+ +-+-+-+-+-+-+ +-+ +-+ +-+ +-+ + +-+-+ +-+ +-+-+ +-+-+-+-+
|   |     |   |     |   | |   | |     | |       | |   |     |
+ +-+-+ +-+ +-+-+ +-+ +-+ + +-+ + +-+ + +-+-+-+ + +-+ +-+-+ +
|   |   |   |   | | |     |     |   |         |       | |   |
+ +-+-+ + +-+-+ + + +-+ +-+-+ +-+ +-+-+-+-+-+ + +-+-+ + +-+ +
| | |     |   |     | |   |           |     | |   |       | |
+ + +-+-+ + +-+-+-+ + +-+ +-+-+-+-+ +-+ +-+ + +-+-+-+-+ +-+ +
|       | | | |   |       | |       | | | | | | |           |
+ +-+-+ + + + +-+ + +-+-+ + +-+-+ +-+ + + + + + +-+ +-+-+-+-+
| |     |   |       | |   | | |   |     |         | | | |   |
+-+ +-+ +-+ +-+ +-+ + +-+ + + +-+-+-+-+ +-+-+-+-+ + + + + +-+
| | | |   |     | |     |         | | |         | |     | | |
+ + + + +-+-+-+ + +-+-+-+-+ +-+-+ + + +-+-+ +-+-+ + +-+ + + +
| |   |     | |   | |   |   |   |   | |   |     |     | |   |
+ +-+-+ +-+ + +-+ + + +-+ +-+-+ + +-+ +-+ +-+-+-+-+ +-+-+-+ +
| |       |   | | |     | |     |     | |                 | |
+ +-+-+-+-+-+ + + +-+-+ + + +-+ + +-+ + +-+-+-+-+-+-+-+-+ + +
|     | |       |       | |   | | |   |       | | |   | | | |
+-+ +-+ +-+-+ +-+-+-+ +-+ +-+ + +-+ +-+-+-+-+ + + +-+ + + + +
| |   |       |     |   |   | | |   | | | | |     | | | | | |
+ + +-+ +-+-+ + +-+ +-+ +-+ +-+ +-+ + + + + +-+-+ + + + + + +
|   | |     | |   | | | |   |           |   |   |     |     |
+-+ + +-+ +-+ +-+-+ + +-+-+-+ +-+-+-+-+ + +-+ +-+-+-+ +-+-+ +
|           |       |     | | |             | | | | | | | | |
+-+-+-+-+-+-+ +-+-+ +-+-+ + +-+-+ +-+-+-+-+ + + + + + + + + +
| |               |   |     | | |     |       |             |
+ +-+-+-+-+ +-+-+-+-+ + +-+ + + +-+-+-+ +-+-+ + +-+-+-+-+-+-+
|   | |       |         | | |             |     |       | | |
+-+ + + +-+-+-+-+-+-+-+ + + +-+-+-+-+-+-+-+-+-+ +-+-+-+ + + +
| | | | |     |   | | |   |           |       | |   |   | | |
+ + + + + +-+ +-+ + + +-+ +-+ +-+-+-+ +-+-+ +-+ + +-+-+ + + +
|           |           | |         |                       |
+-+-+-+-+-+-+-+-+-+-+-+-+-+-+-+-+-+-+-+-+-+-+-+-+-+-+-+-+-+-+