+-+-+-+-+-+-+-+-+-+-+-+-+-+-+-+-+-+-+-+-+-+-+-+-+-+-+-+-+-+-+-+-+-+-+-+-+-+-+-+-+-+-+-+-+-+-+-+-+-+-+-+-+-+-+-+-+-+-+-+-+-+-+-+-+-+-+-+-+-+-+-+-+-+-+-+-+-+-+-+-+
| |           |     | | |           | | |   |   |   | |     |       | | |     |   |   |   | | |   | |     |   |     |     |         |     |   |   |     |     | |
+ +-+-+ +-+-+ +-+-+ + + +-+-+-+ +-+ + + +-+ +-+ +-+ + +-+-+ + +-+-+ + + +-+ +-+ +-+-+ +-+ + + + +-+ +-+ +-+ +-+-+ +-+-+ +-+-+ +-+-+ +-+ +-+ +-+ +-+-+-+ + +-+-+ +
|   | |   |     |     |   |   |   | |         |       | |         | |     | | |     |     | |   |       | | |       |   |   | | |   |             |   | |     | |
+-+ + +-+ +-+-+ +-+ +-+-+ + +-+-+ + +-+-+-+-+ +-+-+-+ + +-+-+-+-+ + +-+ +-+ + +-+ +-+-+ +-+ + +-+-+ +-+-+ + +-+-+-+ +-+ + +-+ + + +-+-+-+-+-+ +-+ +-+ + +-+-+ + +
| |   | | |   |                 | |     |       |         | | |   | |       | |             |     | |   |         | | | |       | | | |     | |       |       | |
+ + +-+ + +-+ +-+ +-+-+-+-+-+-+ +-+-+ +-+-+ +-+ +-+-+ +-+ + + + +-+ + +-+-+ + + +-+-+-+-+-+ + +-+ + +-+ +-+-+-+ +-+ + + +-+-+-+ + + + +-+ +-+-+-+-+ +-+-+-+-+ + +
| | | |         |   |                 | | | |     |     |     |   | | |   |   |   | | | |     |   |   | |   |     | | |     |   |           |                   |
+ + + +-+-+-+-+-+ +-+ +-+-+-+-+-+-+-+ + + +-+-+ +-+-+ +-+-+-+ + +-+ + + +-+ +-+ +-+ + + +-+-+-+-+ +-+ + + +-+ +-+ + + +-+-+ + +-+-+-+-+-+-+-+-+-+-+-+-+-+-+-+ +-+
|   |     | |       | | |   |       |   |   |   | | |     |   |   | | | | |   |           |   | |     |   | | |       | | |   | |     |             |           |
+ +-+ +-+ + + +-+-+-+ + + +-+-+ +-+ +-+ +-+ +-+ + + +-+-+ +-+ + +-+ + + + + +-+-+-+-+ +-+ + +-+ + +-+ + +-+ +-+-+-+ +-+ + + +-+ +-+-+ +-+-+ +-+-+-+-+-+ +-+-+-+-+
|     |       |         | |   |   |   |     |     |     | |   | |   | |   | | |         | |         |   | |   |       | |         |     |   |         |     | | |
+-+-+-+-+-+-+-+-+ +-+-+ + +-+ +-+ +-+-+ +-+ +-+-+ +-+ +-+-+ +-+ +-+ + + +-+ + +-+-+-+-+ +-+-+-+-+-+-+-+ + +-+ + +-+-+ + +-+-+ +-+-+-+ +-+ +-+-+-+ +-+ + +-+ + + +
|               |   | | | |     |   |   |   | |     | | |         | |   |   |   | |   |       |     | | | | | |     |         | | | | | | | | |     | |   |     |
+-+-+-+-+ +-+-+ +-+ + + + + +-+ +-+ +-+ +-+ + +-+ +-+ + +-+ +-+-+-+ + +-+-+ + +-+ +-+ + +-+-+ +-+ +-+ + + + + +-+-+-+-+ +-+-+ + + + + + + + + +-+-+ + +-+-+-+-+ +
|           | |       | |   |   | |     |     |   | | | |     | |     |   | |           |   | | | | | |       |   |     | |   | | | | | | |         |     |     |
+-+ +-+-+-+ + +-+-+-+ + +-+ +-+ + +-+-+-+-+ +-+ +-+ + + +-+ +-+ + +-+ + +-+ +-+-+-+-+-+ +-+ + + + + + +-+ +-+ + +-+ +-+ + + +-+ + + + + + +-+-+-+-+-+-+ +-+ +-+-+
| |       |         | |   | | |     |     |     |         |   |     | | | |   |       | |       | | | |     |   | |   | | | | |       |   |   | |   | | | |     |
+ + +-+-+-+-+-+-+-+-+-+-+ + + +-+ +-+-+ +-+-+ +-+-+-+-+ +-+ +-+-+-+-+ + + + +-+ +-+-+ +-+-+-+ +-+ + + +-+-+-+-+ + + +-+ + + + + +-+-+ + +-+ +-+ +-+ + + + + +-+-+
| | | | |     |   | |   |   | |     |         |   |     |           | |   |     |   |         |       |       |       |   |   | | | | |   |     |   | |     | | |
+ + + + +-+-+ + +-+ + +-+-+ + +-+-+-+-+-+ +-+ + +-+ +-+-+-+-+-+-+-+-+ +-+ +-+-+ + +-+-+ +-+-+ + +-+-+ + +-+-+ +-+-+ +-+-+-+-+ + + + + +-+ +-+-+ +-+ + +-+ +-+ + +
| |           | |       | |             |   |       |   |     |   | | |     | |       |   | |       | |   |       |   | | |         |             |           | |
+ +-+ +-+-+-+ + +-+-+-+ + +-+-+-+-+-+-+-+-+-+-+-+-+ + +-+-+ +-+ +-+ + +-+ +-+ +-+ +-+-+-+ + + +-+-+-+-+-+-+-+ +-+ +-+ + + +-+-+-+-+-+ +-+-+-+-+-+-+-+-+-+-+-+ + +
|     | |           | | | | | | |         |     |           | | | |     | |   | | | | | |   | | | | |   |       |   |         |   | | | | | | |     | |     |   |
+ +-+ + +-+-+ +-+-+ + + + + + + +-+-+ +-+ + +-+ +-+-+-+ +-+ + + + + +-+ + +-+ + + + + + + +-+ + + + + +-+-+-+-+-+ +-+-+-+-+-+ + +-+ + + + + + + +-+ + + +-+ +-+ +
|   |   | | |     |   | |           |   | | | | | |     | |           |   | | | | |       | |         | |     |     |     | |       | |       |   | |   |       |
+-+-+-+ + + +-+-+-+-+ + +-+-+-+-+ +-+-+ + + + + + + +-+ + +-+-+-+-+-+ +-+ + + + +-+-+-+ +-+ +-+-+-+ +-+ +-+ +-+-+ +-+-+-+ + + +-+-+-+ +-+-+ +-+-+ + +-+ +-+-+-+-+
|   |   |                         |     |     | |   |         | |   |   | | |       |       |     |         |         | | |   |   |     | | |     |         | | |
+-+ +-+ +-+-+-+-+-+-+-+-+-+-+-+-+ +-+-+-+ +-+-+ + +-+-+-+-+-+ + + +-+-+-+ + + +-+-+ +-+ +-+-+-+-+ +-+-+-+-+ +-+-+ +-+ + + +-+ + +-+-+ +-+ + +-+-+-+-+-+-+ +-+ + +
| |   |   |   |         |     |           | | | | |     | | |     |       |       | |         |       | |       |   | |     |   |       |   |             | |   |
+ + +-+-+ + +-+-+ +-+-+ + +-+ +-+-+-+-+ +-+ + +-+ + +-+ + + +-+-+ +-+-+-+ +-+ +-+-+ +-+ +-+-+ + +-+-+ + + +-+-+ + +-+ +-+ +-+-+-+-+-+ +-+-+ +-+ +-+-+-+-+ + +-+ +
|       |     |       |   |   |   |     |           | | |       |   | |           |   |   | |     | |   | |         |           | | |             |     | |     |
+-+-+ +-+-+ +-+-+-+-+-+-+ +-+ +-+ +-+-+-+-+-+-+-+ +-+ + +-+-+-+ + +-+ + +-+-+-+-+-+-+-+-+ + + +-+ + +-+-+-+-+-+-+-+-+-+-+-+ +-+ + + +-+ +-+-+-+-+ +-+-+ + +-+ +-+
| | | |   |         |       |         |             | |       | | | |       |           |   |   |             |       |       |       | |         | |       | | |
+ + + +-+ +-+-+ +-+ +-+-+-+-+-+-+ +-+ + +-+-+-+-+-+ + + +-+-+ + + + +-+-+-+ +-+ +-+-+-+ +-+-+-+ +-+-+-+-+-+-+ + +-+-+-+-+-+-+-+-+-+-+-+-+-+-+ +-+ + +-+ +-+ + + +
|   |       | |   |       | |   | | | |   | |     |   |     | |       |   |     | |     | |   |             |       | |   | |     | | | |   | | |     |   | |   |
+ +-+-+-+-+ + +-+-+ +-+-+-+ + +-+ + + +-+ + +-+ +-+-+-+-+-+-+-+-+ +-+ + +-+-+ +-+ +-+ +-+ + +-+-+-+-+-+-+-+-+-+-+ +-+ + +-+ + +-+ + + + +-+ + + +-+-+ +-+-+ + +-+
|       | |   | | | | |   | |       |   | |       | | | |         |   | |   | | | |   |         | | |   |     |         |     |   |         |   |       | |   | |
+-+-+-+ + +-+ + + + + + +-+ +-+-+-+-+-+ + +-+ +-+ + + + +-+-+-+-+-+ +-+ +-+ + + + +-+ +-+-+ +-+ + + + +-+ +-+-+-+-+-+ +-+ +-+-+-+ +-+-+-+-+ +-+-+-+-+ +-+ + +-+ +
|       |       |   |     |       | | |   | | | | | |               |     |   |   | |       | |   | |   | | |         | |       |     |   |   | | |     |     | |
+-+-+ +-+-+-+ +-+-+ + +-+ +-+-+-+ + + +-+ + + + + + + +-+-+-+-+-+-+ +-+ +-+ +-+ +-+ +-+ +-+ + +-+ + + +-+ + +-+-+-+ +-+ +-+-+ +-+-+-+ +-+ + +-+ + +-+-+-+-+ +-+ +
|     | |   | |       | | |   | |   |   | | |   |   | | |   |     | | |               | |     |             |   |   |           |     | | |     | |           | |
+ +-+ + +-+ + +-+ +-+ + + + +-+ + +-+ +-+ + + +-+-+ + + +-+ +-+-+ + + +-+-+-+-+-+-+-+-+ +-+-+-+-+-+-+-+-+-+ + +-+-+ +-+-+-+-+-+-+-+-+ + + + +-+ + +-+ +-+-+-+-+ +
| |           |     |   |   |         |         |   | |     | |           |       | |   | |   | | |     | | |   |       |     |   |   |   |   |       | |   | | |
+-+-+ +-+-+-+ +-+-+-+-+-+ +-+-+-+-+-+ +-+-+-+ +-+-+-+ +-+-+ + +-+-+-+-+ +-+ +-+-+ + + +-+ +-+ + + + +-+ + + +-+ +-+ +-+-+-+-+ + +-+ +-+ +-+ +-+-+-+-+ + +-+ + + +
|       |                 |   |       |     |   | |   | |           | |     | |     |     | |       |     |       |       | |             | |     | | |         |
+-+-+-+-+ +-+-+-+-+-+-+-+ + +-+-+ +-+ +-+ +-+ +-+ +-+ + +-+-+-+-+-+ + +-+ +-+ +-+-+-+-+-+ + +-+ +-+-+-+-+ +-+-+-+-+-+ +-+ + +-+-+-+-+-+ +-+ + +-+ + + +-+-+ +-+-+
|   | | |               | | |       |   |   |   | |   |   |           |   |     |     | |   |   | |   | |     |     | |       |   | | |     | |   | |   | |     |
+-+ + + +-+-+-+-+-+-+-+ + + +-+-+-+-+-+ +-+ + +-+ +-+ +-+ +-+-+-+-+-+ +-+ +-+-+ +-+-+ + +-+ + +-+ +-+ + + +-+ +-+ +-+-+-+-+ +-+ +-+ + + +-+ +-+ +-+ + +-+ +-+ +-+
|   | |       |   | | | |   |       |     | |   | | |   | | | |           | |       |       |       | | | |   | | |     |       |   |     |       | |           |
+ +-+ +-+-+-+ + +-+ + + +-+ +-+-+ +-+-+-+ + + +-+ + +-+ + + + +-+-+-+ +-+ + + +-+-+ +-+ +-+ +-+ +-+ + + + +-+ + + +-+-+ +-+-+-+ +-+ + +-+ +-+-+-+ + +-+-+-+-+ +-+
|   |         |   |       | |   |     | |     |     | |         |   |   | |       |   |   |   | | |   |   | |     |     | |     |       |   | |     |           |
+ +-+-+-+ +-+ + +-+ +-+-+ + +-+ +-+ +-+ +-+ +-+-+ +-+ +-+-+ +-+ + +-+-+-+ +-+-+-+-+ +-+-+-+-+ + + +-+-+-+ + +-+ +-+ +-+ + +-+-+-+-+-+-+ +-+ + + +-+-+-+ +-+-+-+-+
|   |       |   | | |     |   | | |   |   |       | |   |     | | |   | | | |     |   | | |             | |           |   | |   |   |   |     | |               |
+-+ +-+-+-+ +-+ + + +-+-+-+-+ + + + +-+-+ +-+-+-+ + +-+ +-+ +-+ + +-+ + + + +-+-+ + +-+ + +-+-+-+-+-+-+-+-+-+-+-+-+-+ +-+ + + +-+-+ +-+-+-+-+-+-+-+-+-+ +-+-+-+-+
|   |         |         |     |     |   |   | |           |   | |   |   |     |       |     |     |         |       | | |         | | | | |   |               | |
+-+ +-+-+-+-+-+-+-+-+ +-+-+-+ + +-+ +-+ +-+ + +-+-+-+-+-+-+ +-+ +-+ + +-+-+-+ +-+ +-+ +-+ +-+ +-+-+-+-+ +-+ + +-+-+ + + +-+ +-+-+ + + + + +-+ +-+-+-+-+ +-+-+-+ +
| | |   | |     |       |         |           |       |   | | | |   |         |     |     | | | | |       | | |   | | | | |     |     | |       | | |         | |
+ + +-+ + + +-+ +-+-+ +-+-+-+-+-+-+-+-+-+-+-+ +-+ +-+-+ +-+ + + + +-+-+-+-+ +-+-+ +-+-+-+ + + + + +-+-+ +-+ + + +-+ + + + +-+-+-+ +-+ + + +-+-+ + + +-+-+-+-+ + +
| | | | |   | |     |       |       |       |   |         |   |     |   |   |     |                 |   |     | |     | | |   | | |   |       | | | | |         |
+ + + + + +-+ +-+ +-+ +-+-+ +-+-+ +-+-+ +-+ +-+ +-+-+-+-+ +-+-+-+ +-+ +-+-+ +-+-+-+-+-+-+ +-+-+-+-+ +-+-+-+-+ + + +-+ + + + +-+ + +-+ + +-+-+-+ + + + +-+-+ +-+-+
| |             |   |     |           |   | | | |   |     | |   | | |                 | |   | |   | |   | | |   |   | | | |         |       | | |         | | | |
+ +-+-+-+-+-+-+ +-+ +-+-+-+-+-+-+-+-+ + +-+ + + +-+ + +-+ + + +-+ + +-+-+-+-+-+-+ +-+ + +-+ + + +-+ + +-+ + +-+-+ +-+ + + +-+-+ +-+-+-+-+-+ + + +-+-+-+ +-+ + + +
|     | |     |   | |       | | |     | | | |   | |     |     |                 |   | | | | |       | | |     |     |   |         |           | |   |     |     |
+-+-+ + + +-+ + +-+-+-+-+ +-+ + + +-+ + + + + +-+ +-+-+ +-+-+-+-+-+-+-+-+-+-+-+-+-+ + + + +-+ +-+-+ + + + +-+-+ +-+-+-+-+-+-+-+-+-+-+-+-+-+-+-+ + +-+ +-+ + +-+-+
|     | |   |     |     | |     |   | | |       | |           |       | | | |     | |   |         | | |   |         | | | | | | | |           |         | | |   |
+-+-+ + +-+-+-+-+ +-+-+ + +-+ +-+-+-+-+-+-+-+ +-+ +-+-+-+ +-+ + +-+-+ + + + +-+ +-+-+ +-+-+-+ +-+-+ + +-+ +-+-+-+-+ + + + + + + + + +-+-+-+-+ +-+ +-+-+-+-+ +-+ +
|     |       |   | | | | |     |     | | |           |     |   |   |     |     |   |   | |   | |   | | |         | |     |   | |   |                 |     | | |
+ +-+ +-+-+-+ +-+ + + + + +-+-+ +-+ +-+ + +-+ +-+-+-+ +-+-+ +-+ +-+ +-+ +-+-+ +-+ +-+-+ + +-+ + +-+ + + + +-+-+-+ + + +-+ + +-+ +-+ +-+-+-+-+-+-+-+-+-+-+-+ + + +
| |     | |   |   |         |       |       |   |   |   |     |   | |   |           |   |   |     |     |       | |     |         |     |       | |       |     |
+ +-+-+ + + +-+-+ +-+-+-+ +-+-+ +-+-+-+ +-+ + +-+ +-+ +-+ +-+-+-+ + + +-+-+-+-+ +-+ + +-+ +-+-+-+-+ +-+ +-+-+-+ + +-+-+-+-+-+-+-+ +-+-+ +-+-+-+ + +-+ +-+ +-+-+ +
|   | | | |   |                 | | |     |     |     | |     |     |         | |     |               |         |     |       | | | |   | | |       |   |       |
+-+ + + + +-+ + +-+-+-+-+-+-+-+ + + +-+-+-+-+-+-+-+ +-+ +-+-+-+-+-+ +-+-+-+-+ +-+-+-+ +-+-+-+-+-+-+-+-+ +-+-+-+-+-+ +-+ +-+-+ + + + + +-+ + + +-+-+ + +-+-+-+ +-+
|     |     |   |   |     | |       | |   |     |   |     | |               | | | |           | | |     | | |         |   |         |     |       | |   | | |   |
+-+-+-+-+ +-+ +-+ +-+-+ +-+ +-+ +-+ + + +-+ +-+ + +-+-+ +-+ +-+-+-+-+-+-+-+-+ + + +-+-+-+-+ +-+ + +-+ +-+ + + +-+-+-+-+-+ +-+-+-+-+-+-+-+ +-+ +-+ + +-+ + + +-+ +
|       | |     | |       | | | |   | |   |   |       |   | |   | | |   |                       |     | |           |     |           |     | |   | | |       | |
+-+-+ +-+ +-+-+ + + +-+-+ + + + +-+ + +-+ +-+-+-+-+ +-+ +-+ +-+ + + +-+ + +-+-+-+-+ +-+-+-+-+-+ +-+ +-+ +-+-+-+-+ +-+-+-+ +-+-+-+-+-+ +-+ +-+-+-+-+ + +-+-+ +-+-+
|   |           | |   | | |   |   |   |         |         | | | | |   | | |       |           | |           | | |           |     |   |           | | | |     | |
+-+ + +-+-+-+-+ + + +-+ + +-+ +-+-+-+ + +-+-+-+ +-+-+ +-+ + + + + + +-+ + +-+-+-+ +-+ +-+-+-+-+-+-+-+-+-+-+ + + + +-+-+-+-+ +-+-+ + +-+-+-+-+ +-+ + + + +-+-+ + +
| |         |   | |     | | | |       |   | |         | | | |   | |         | |   | | | |   | |     |           |   | |   | |   |   |       |   |         | | | |
+ +-+-+-+-+ +-+ + +-+ +-+ + + +-+ +-+ + +-+ +-+-+-+-+ + + + + +-+ +-+-+-+ +-+ +-+ + + + + +-+ +-+ +-+ +-+-+-+-+-+-+ + +-+ + +-+ +-+ +-+ +-+ +-+-+-+-+ +-+ + + + +
|       | | | |   |   | | |     |   |           |   |   | |     | |         | |   | | | |         |       |   | | |       | | | | |       | | |       |   |     |
+ +-+-+ + + + + +-+-+ + + + +-+ +-+ +-+-+-+-+-+ + +-+-+ + + +-+ + +-+-+-+ +-+ + +-+ + + +-+-+-+ +-+-+-+ +-+-+ + + +-+ +-+-+ + + + + +-+-+-+ + +-+-+-+ +-+-+-+-+-+
|     | | |   |       |   | |       | |           |   | |     |         |           |   |       | |   | |         | | |   |     | | |   | |   |     | |   | |   |
+-+-+ + + +-+-+ +-+-+-+-+-+-+-+-+-+ + +-+ +-+-+-+ + +-+-+-+-+-+-+-+-+-+-+-+ +-+-+-+-+-+ + +-+-+ + +-+ + +-+ +-+-+ + + + +-+-+-+ + + + +-+ +-+ +-+ +-+ + +-+ +-+ +
|     | |           |   | |         |     | |         | |   | |           |     |   |   |     |         | | |   | | |   | |     |       | |   | |     |     | | |
+-+-+ + +-+ +-+-+-+ +-+ + +-+-+-+-+-+-+-+ + + +-+ +-+ + + +-+ + +-+-+-+-+ +-+ +-+-+ +-+-+-+ +-+-+-+-+-+ + + + +-+ + +-+ + +-+-+ +-+-+ +-+ + +-+ +-+-+ + +-+ + + +
|   | |     | |       |   | |       | | | | | | | | | |   | |   |   |               | | | |       | |   |       |   |     | | |   | | |               | | | | | |
+-+ +-+ +-+ + +-+-+ +-+-+ + + +-+-+ + + + + + + + + + + +-+ +-+ + +-+-+-+-+ +-+-+-+ + + + + +-+-+ + +-+ +-+-+ +-+-+ +-+ +-+ + + +-+ +-+-+-+-+-+-+ +-+ + + + + + +
|   | | |   |   |                 |     |   |   |   | |   |   |       | |     | |       |     | |     | | | |     | |   | | |   |     |       | |   |     | |   |
+-+ + +-+-+ + +-+-+-+-+-+-+-+-+-+-+-+-+-+-+-+-+ +-+-+-+-+ +-+ +-+ +-+ + +-+ +-+ +-+-+ +-+-+ +-+ +-+-+ + + + +-+-+ + +-+ + + +-+ +-+ +-+-+-+-+ + +-+-+-+-+ + +-+ +
| | |   |   | | | |   |     |         |   | | |   | |   |       |   |     |       |     |     |     | |   | | | | |         |   |   |   |   | |     |   | |   | |
+ + +-+ + +-+ + + +-+ +-+-+ +-+-+-+ +-+ +-+ + + +-+ +-+ +-+-+-+ +-+-+-+-+-+ +-+-+-+-+-+-+-+-+ + +-+ +-+ +-+ + + +-+ +-+-+ +-+-+ + +-+-+ + +-+ + +-+ +-+ + +-+-+ +
|   |           |           | | |   | | |                       |       |     |       |       | |   | | |     |       |       | | | | |   |     |       | |   | |
+ +-+-+-+ +-+-+ +-+-+-+-+-+ + + + +-+ + +-+ +-+-+-+-+-+-+-+-+-+ +-+-+ +-+ +-+ + +-+-+ +-+ +-+ + +-+ + + +-+ +-+-+-+-+-+-+-+-+-+ + + + + +-+ +-+-+-+-+-+ + + +-+ +
| |         |   |     |     | |     |   |   | |   | |           |       |   |     | |   |   |     | |               |       |           | |   | |   |   |       |
+ + +-+-+-+-+-+-+ +-+ +-+-+ + +-+-+ + +-+-+ + + +-+ +-+-+ +-+ +-+-+-+ +-+-+-+-+-+ + +-+-+-+ +-+-+-+-+-+-+-+-+-+-+-+ +-+ +-+ +-+-+-+-+ +-+ +-+ + + +-+ +-+ +-+-+-+
| |       |         | |           |   | |     | |     |     | | | | |     | |         |         |       |             | |     | | |     |     |     |   | |     |
+ +-+-+-+ +-+ +-+-+-+ +-+-+-+ +-+ +-+ + + +-+ + +-+ +-+-+-+-+ + + + + +-+ + +-+-+-+-+ +-+-+-+-+ + +-+-+ +-+-+-+ +-+-+-+-+-+-+ + + +-+-+ +-+ +-+-+ +-+-+ + +-+ +-+
| | |       |   | |   |         |   |       | |   | | | |             |     | | |       |         | |   |   |                   |     |   |         | | |   |   |
+ + +-+-+ +-+-+ + + +-+-+ +-+-+-+-+ +-+ +-+-+ + +-+ + + +-+-+ +-+-+-+-+-+-+ + + +-+-+-+-+-+-+-+-+ + +-+ +-+ +-+-+-+-+-+-+ +-+-+ + +-+ +-+ +-+-+ +-+ + + +-+ +-+ +
|   | |   |       |       | |   | | |   |   | | | | |     | | | | | | | | |         | |               | |   |           | |   | | | | |           | |   | | |   |
+ +-+ + +-+-+-+-+-+-+ +-+ + +-+ + + + +-+-+ + + + + +-+-+ + + + + + + + + +-+-+-+-+ + +-+-+ +-+-+-+-+-+ +-+ + +-+-+-+-+ + +-+ + + + + +-+-+-+-+ +-+-+-+ + + +-+ +
| | |         |         | | |               |   | |       |           | | |             |   | |       | |       |         | | | | | | |       | |   |   |   | | |
+ + +-+ +-+-+ +-+-+-+ +-+ + +-+-+-+-+-+-+-+-+ +-+ +-+-+-+ +-+-+-+ +-+ + + +-+ +-+-+ +-+-+-+ + +-+-+ +-+-+-+ +-+-+-+-+-+-+ + + + + + + +-+-+-+ + +-+ +-+-+-+ + + +
| |       |         |   | | |   |         |     |   |     | |       |   | |   |   | | |   |   | |     | | |   | | |   | | |         | |   |               |   | |
+ +-+-+-+-+-+-+-+-+-+-+ + + + +-+-+-+ +-+ +-+ +-+-+ + +-+ + +-+-+ +-+-+ + + +-+ +-+ + +-+ + +-+ +-+-+ + + +-+ + + +-+ + +-+ +-+-+-+-+ +-+ +-+ +-+ +-+-+-+-+-+-+ +
|       | |   |   |     |   | |   | |   |   | | | | | |       |     | |   |     |   |     |     |         |   |     | |     |     | |       |   | |   |   |     |
+ +-+-+ + +-+ +-+ +-+-+-+-+ + +-+ + + +-+-+ + + + + + +-+-+-+ +-+ +-+ +-+-+-+-+-+-+ + +-+ +-+-+ + +-+-+-+ +-+ + +-+ + +-+-+ + +-+ + +-+ +-+-+-+-+ + +-+ +-+-+ +-+
|     |         | |     | | |       |     |   | |           |   |   |   | |             | |       | | | | |       | | | |     |       | |       | |   |   |     |
+-+-+-+-+-+-+-+ + + +-+ + + + +-+-+ +-+ +-+-+ + + +-+-+-+-+-+-+ + +-+ +-+ + +-+-+-+-+-+-+-+-+-+-+ + + + +-+-+-+-+ +-+ + +-+-+-+-+-+-+-+ +-+-+-+ + +-+ + +-+-+ +-+
| | | |   | |   |     |           | | | |       |       |                 | |             |         |   | |         | |   |     | |             |               |
+ + + +-+ + +-+ +-+-+ +-+-+-+-+-+-+ + +-+-+ +-+-+-+-+-+-+-+-+-+-+-+-+-+-+-+ +-+-+-+-+-+ +-+-+ +-+-+ +-+ + + +-+-+-+ + +-+ +-+ +-+ +-+-+-+-+-+-+-+-+-+-+-+-+-+-+ +
|   |   |     |   | |       |     |       |         |       | |   |             |                 |   |           |         | | | | | |       | | |       |   | |
+-+ +-+ + +-+ + +-+ +-+-+ +-+-+-+ +-+-+-+-+-+-+-+-+ + +-+-+ + +-+ +-+-+-+-+-+ +-+-+-+-+-+-+ +-+-+-+ +-+-+-+-+-+-+-+-+-+-+-+ + + + + + +-+-+-+ + + +-+-+ +-+ +-+ +
|       |   | |         | |       |   | |   | | | | |     | | | |     | | | |         | |       |     |   |   |     |     |         | | |     |   |     | | |   |
+-+-+-+ + +-+ +-+ +-+-+ + +-+-+-+ + +-+ +-+ + + + + + +-+-+-+ + +-+-+ + + + +-+-+-+ +-+ +-+ +-+ +-+-+ + +-+ +-+-+-+ + +-+ +-+-+-+-+ + + + +-+ + +-+-+-+ + + + +-+
|   |       | | |     |     | |   |   | | | | | |   |         | |   | |     | |   |       |   |   |   |   | |   |       |   | | | |     |   | |               | |
+-+ +-+-+-+-+ + +-+-+-+-+ +-+ +-+ + +-+ + + + + + +-+-+-+-+-+ + + +-+ + +-+ + + +-+ +-+ +-+-+-+-+-+-+ +-+ + + +-+ +-+-+-+-+ + + + + +-+-+-+-+ +-+-+ +-+-+-+-+-+ +
|                                             |                         |         |   |         |               |         |                   |                 |
+-+-+-+-+-+-+-+-+-+-+-+-+-+-+-+-+-+-+-+-+-+-+-+-+-+-+-+-+-+-+-+-+-+-+-+-+-+-+-+-+-+-+-+-+-+-+-+-+-+-+-+-+-+-+-+-+-+-+-+-+-+-+-+-+-+-+-+-+-+-+-+-+-+-+-+-+-+-+-+-+