+-+-+-+-+-+-+-+-+-+-+-+-+-+-+-+-+-+-+-+-+-+-+-+-+-+-+-+-+-+-+-+-+-+-+-+-+-+-+-+-+-+-+-+-+-+-+-+-+-+-+-+-+-+-+-+-+-+-+-+-+-+-+-+-+-+-+-+-+-+-+
|   | |   | |     |   |             | | |     | |               |             | | |   |           |       |   | | | | | |   | |             |
+ +-+ + +-+ + +-+ +-+ +-+-+-+ +-+-+ + + + +-+ + + +-+-+-+-+-+-+ +-+-+-+-+ +-+ + + + +-+-+ +-+-+-+ +-+-+ +-+ +-+ + + + + + +-+ +-+-+-+-+-+ +-+
| |   |   |     | | | | |         |         | |   |   | |     | | |   | | |         |     | |       |       | |       |     | |   | | |   | |
+ + +-+-+ +-+ +-+ + + + +-+-+-+ +-+-+-+-+-+-+ + +-+-+ + +-+-+ + + + +-+ +-+-+-+-+-+ + +-+ + +-+-+-+ + +-+-+ + +-+ +-+ +-+-+ + + +-+ + + +-+ +
| | |   |       |     |     |             |   |     |     | |       | | | |           |   | |   |       | |         | | |     | | |         |
+ + + +-+-+-+ +-+-+-+ +-+-+ +-+-+-+-+-+ +-+-+ +-+-+ + +-+ + +-+-+-+ + + + +-+-+-+-+ +-+-+ + +-+ +-+-+-+ + + +-+-+-+-+ + +-+-+ + + +-+-+-+ +-+
| |   |             |         | |   | |     | |         | | | |     |         |     |   | | | | |     | | | | |       | |     |   |     |   |
+ + +-+-+-+-+-+-+-+-+-+ +-+-+ + + +-+ +-+ +-+-+-+-+-+-+ + + + + +-+-+-+-+ +-+ +-+ +-+-+ + + + + + +-+ + + + + + +-+-+ + +-+ +-+ +-+ +-+-+-+ +
|   | |       |       | |   |     | |                 | |     |       |     | |   | | |       |   |     |   |   | |   | |                 | |
+ +-+ +-+ +-+ + +-+-+ + + +-+-+ +-+ +-+-+-+-+-+-+ +-+ +-+ +-+-+-+-+-+ + +-+-+ + +-+ + +-+-+-+-+-+-+-+-+-+-+-+-+ + + +-+ +-+-+ +-+-+-+-+-+-+ +
| | |       |       | | |   |     | | | |     |     |               |   |   | |   |       | |   |   |   |         |     |     | |     |     |
+ + +-+ +-+-+-+-+-+-+ + + +-+-+-+ + + + +-+-+ +-+-+-+-+-+-+-+-+ +-+-+-+ +-+ + +-+ +-+-+-+ + + +-+-+ + +-+-+-+-+ +-+-+-+ + +-+ + + +-+ +-+-+ +
|   |     |   |                 | |   |   | | | | |         |   |       |       |     | |     |     | |   |       | |   | | | | | | |       |
+ +-+ +-+ + +-+ +-+ +-+-+-+-+ +-+ +-+ + +-+ + + + +-+ +-+ +-+ +-+-+-+-+-+-+-+-+ +-+-+ + +-+-+ +-+-+ + +-+ +-+ +-+ + +-+ + + + + + + +-+-+ +-+
|       |     | | |     |       | |   | |         | |   | |         |     |   | |   |   |               |   | | |     |     |   | | |   |   |
+-+-+-+-+ +-+-+ + +-+-+-+-+ +-+-+ + +-+ + +-+-+-+ + + +-+ +-+-+-+-+ + +-+ +-+ + +-+ + +-+-+-+-+-+-+ +-+ + +-+ + + +-+-+-+-+-+-+ + + + +-+-+ +
| | | |     |             |     |   |     |     | |     | |   |   | |   |     | | |   |     | | |   | |   |   | |   | |           |       | |
+ + + +-+-+-+-+-+-+-+-+-+-+ +-+-+-+ + +-+ +-+-+ + +-+ +-+ +-+ + +-+ +-+-+ +-+ + + +-+ +-+-+ + + + +-+ + +-+-+ + + +-+ +-+-+-+-+ +-+-+-+-+ + +
|     |     |   | |               |     |       |   | | |           | | |   |       | | | |           | | |     |       | |   | |   |       |
+ +-+ +-+-+ +-+ + +-+-+-+-+-+-+-+-+-+-+-+-+-+-+-+-+ + + +-+-+-+-+ +-+ + +-+-+-+-+-+ + + + +-+-+ +-+-+-+ + +-+ +-+-+-+-+ + + +-+ +-+ +-+-+ +-+
| | |   | |         | |     |   |     |     | |     | | | | | |     | |   |     |         | |       | | |         |     |       |       |   |
+ + + +-+ +-+ +-+-+ + + +-+ +-+ + +-+ + +-+ + + +-+ + + + + + +-+ +-+ +-+ + +-+ +-+-+-+-+ + +-+-+-+ + + +-+-+-+-+-+-+-+-+-+ +-+-+ +-+-+ + +-+
|   | | |     |   | |   | |     |   |     |   |   |     | |             |     |   | | |       |     |   |     | | | | |     | | | | |       |
+ +-+ + + +-+ + +-+ + +-+ +-+-+ + +-+-+-+-+-+-+-+-+-+ +-+ +-+-+-+ +-+ +-+-+ +-+-+ + + +-+-+-+ +-+-+ +-+-+ +-+ + + + + + +-+ + + + + +-+-+ +-+
| | |       |     |     |   | |           |     | |     | |     |   | |         |       |   | |             |   | | | | | |     |       |   |
+ + +-+-+-+ +-+-+-+-+-+ +-+ + +-+-+-+ +-+ + +-+ + +-+-+ + +-+ +-+ +-+ +-+-+-+-+-+ +-+-+ +-+ + +-+ +-+-+-+-+-+-+ + + + + + + +-+-+-+-+-+-+-+-+
|       |   |       |   | |   | |       | | | |         | |       |     | |   |   | | |     |   | |   | |   |             |     | |       | |
+-+-+-+ +-+ + +-+-+ +-+ + +-+ + +-+-+ +-+ + + + +-+-+-+ + +-+-+-+-+-+-+ + + +-+ +-+ + +-+-+ + +-+ + +-+ + +-+-+-+ +-+-+-+-+-+-+ + +-+-+ +-+ +
|         |       |   |   |             |   |   |         | | | |       |                 |     | | | |       | | |       |     |   |   |   |
+-+-+-+-+-+ +-+-+-+-+-+-+-+-+-+-+-+-+-+-+-+-+-+-+-+-+-+-+ + + + +-+-+ +-+-+-+-+-+-+-+-+-+-+-+-+-+ + + +-+-+-+ + + +-+-+ +-+-+ +-+-+ +-+ +-+ +
| |   | |   | |       | |             | | | |   | | | |     | |     |   | | | |   |   | |   |       |     |           |   |     | |     |   |
+ + +-+ + +-+ + +-+-+-+ +-+-+-+-+ +-+ + + + +-+ + + + + +-+ + + +-+ +-+ + + + + +-+ +-+ +-+ +-+-+ +-+ +-+ +-+-+-+ +-+ + +-+-+-+ + + +-+-+-+ +
| | | | |       |             |   | |   | |   | |       | |   |   | | |           | | |       |         | |   |   | |   |   | |         | | |
+ + + + +-+ +-+ + +-+-+-+-+-+ +-+ + + +-+ +-+ + +-+-+ +-+ +-+ +-+-+ + +-+-+-+-+-+ + + +-+ +-+ +-+ +-+-+-+ + +-+-+ + +-+ + +-+ +-+-+-+ +-+ + +
|   |         |   |                 | |       |   | | |   |               |       |         |   |     | | | |     |           |   | |       |
+-+ +-+-+-+-+-+-+-+-+-+-+-+-+-+-+-+-+ +-+-+-+ +-+ + + + +-+-+-+-+-+-+-+-+-+-+-+ +-+-+-+-+-+-+ +-+-+ +-+ + + +-+ +-+-+-+-+-+-+ +-+ + +-+ +-+-+
| |     | | |           | | |   | |   |         |                     | |   | |   |   |       |         |   |   |       |         | |     | |
+ +-+-+ + + +-+-+-+ +-+ + + + +-+ + +-+-+-+ +-+ +-+ +-+-+-+-+-+-+-+-+ + +-+ + +-+ + +-+ +-+-+ +-+-+ +-+-+-+-+-+ +-+-+-+ +-+ +-+-+ + +-+-+ + +
|       |   |   |     |   | | | |     | | |   |     |     | | |   |   |           | |   |   | |         |   | | |   | | |   |     |     | | |
+-+-+-+ + +-+-+ +-+-+-+ +-+ + + + +-+ + + +-+-+ +-+ +-+ +-+ + + +-+ +-+-+-+-+-+ +-+ +-+ + +-+ +-+-+-+ +-+ +-+ + +-+ + + +-+-+ +-+ +-+-+ + + +
|       |     |       |   |   |     |   | | | |   |         | | |             |             |       | |       |       | |   | |     | |   | |
+-+ +-+ +-+-+ +-+ +-+ +-+ +-+ +-+ +-+-+-+ + + +-+-+-+-+-+ +-+ + +-+-+-+-+-+-+ +-+-+-+ +-+-+-+-+-+-+-+ + +-+-+-+-+-+ +-+ +-+ +-+ +-+ + +-+ + +
| | | |       |   |   |   |     | |         |       |         |             |   | |   | |               |       |       |         |     | | |
+ + + +-+-+-+ +-+-+ +-+ +-+ +-+ + +-+-+ +-+ +-+-+-+ +-+ +-+-+ +-+-+ +-+-+-+ + +-+ +-+ + +-+-+ +-+ +-+-+ +-+-+ +-+-+-+-+ +-+-+-+-+-+-+-+-+-+ +
| |     | |   | |         |   |     |   |   | |   |   | | | | |   | | |       |             | | |     | |   | |     | | |       | |     | | |
+ +-+-+ + + +-+ +-+ +-+-+-+ +-+-+-+ +-+ +-+ + + +-+-+ + + + + +-+ + + +-+-+-+-+-+-+-+-+ +-+-+ + +-+-+ + +-+ + +-+ +-+ + + +-+-+ + + +-+ + + +
|     |   |   |   | | |           | | |   | | | |       |     | | |           | |     |     | | |   | |     | | |   |   |     |   | |     | |
+-+ +-+-+ +-+ +-+ + + +-+ +-+-+-+-+ + +-+ + + + +-+-+-+-+ +-+ + + +-+-+ +-+-+ + + +-+ +-+-+-+ + + +-+ +-+-+ + + + +-+ +-+-+-+ +-+-+ +-+-+-+ +
|   |   |   |     |   |       | | | |   | | |         |     | |     | |   |         |       |     | | | | | |           |   | |       |   | |
+ +-+-+ + +-+-+ +-+-+ +-+-+-+ + + + + +-+ + +-+-+ +-+ + +-+-+ +-+ +-+ +-+-+-+-+-+-+-+-+-+-+-+-+ +-+ + + + +-+-+ +-+-+ +-+ +-+ +-+-+-+ +-+ + +
| | |   | |   |         |   |     |     | |   | | |       |       |   |   |       |   |     | | |         | | | |       |   | |       | | | |
+ + +-+ + + +-+-+-+-+ +-+-+ +-+-+ +-+-+ +-+ +-+ +-+-+-+-+-+-+-+ +-+-+ + +-+-+-+-+ + +-+-+-+ + + +-+ +-+-+ + + +-+-+-+ +-+-+ + + +-+-+ + + + +
| |     | | | |   |     |   | | |   |   |   | |     | |           | | |       |     | |           |     |       | | | | |   |   | | | |   | |
+ +-+ +-+ + + + +-+-+ +-+ +-+ + +-+-+ +-+-+ + + +-+ + +-+ +-+-+-+ + + +-+-+ +-+ +-+ + +-+-+-+-+-+-+-+-+-+-+ +-+ + + + + +-+ +-+ + + + +-+ + +
|                 |       |   |       |   |   |   |     |       |       | |   |   |   |       |   | |   | |   | | |   | |   |   | | | |     |
+-+-+-+ +-+-+-+-+-+-+-+-+ + +-+-+ +-+ + +-+ +-+ +-+-+ +-+-+-+-+-+-+-+ +-+ + +-+-+-+ +-+ +-+-+ + +-+ +-+ + +-+ + + + +-+ +-+ +-+ + + + +-+-+ +
| |   |       |   |   |         |   |       | | | | |             |     | | |     |       |     |       |   | | |   | |     |   |       | | |
+ + +-+-+ +-+ +-+ +-+ + +-+-+-+ +-+ +-+-+-+ + + + + +-+-+-+-+-+-+ +-+ +-+ + +-+ +-+-+-+-+-+-+ +-+ +-+-+ + +-+-+ +-+ + +-+ +-+-+ +-+-+-+ + + +
|       |   |   |   |       |             |             | | |     | | |     |     |     |         |       | |     |   | |       |   | | |   |
+-+ +-+ +-+ +-+ +-+ + +-+-+-+-+-+-+-+-+-+-+-+-+-+-+-+-+ + + +-+ +-+ + +-+ +-+-+-+ +-+-+ +-+ +-+-+-+-+-+-+ + +-+-+-+-+ + +-+-+ +-+-+ + + + +-+
| |   | |     | | | |                   |         | |     |   | | |   |             | | |           | |       | | |   |       | | | |   |   |
+ +-+ + +-+-+ + + + +-+-+-+ +-+-+-+-+-+ + +-+-+-+ + +-+ +-+ +-+ + +-+ +-+-+ +-+-+-+ + + +-+-+-+-+ +-+ +-+ +-+ + + + +-+-+-+-+ + + + + +-+-+ +
| |   |   | | |   |   |             | | |   | |       |     |     |   | |   |           |       |     |   |         |   |     |       | |   |
+ + +-+-+ + + +-+ +-+ + +-+-+-+-+-+ + + +-+ + +-+-+ +-+-+-+-+-+-+-+ +-+ +-+-+ +-+-+-+-+ +-+-+-+ +-+-+-+-+-+-+-+ +-+ +-+ +-+-+ +-+ +-+ + +-+ +
| | |           |     |     |       | | |     |   | |   | | | | | | |               |   |     |     | |   |     |           |   | | |       |
+ +-+-+-+-+-+-+ +-+-+-+-+-+-+-+-+-+ + + + +-+ +-+ + + +-+ + + + + + +-+-+ +-+-+-+-+-+-+ +-+-+ +-+ +-+ + +-+-+-+-+-+-+-+-+-+ +-+-+ + +-+ +-+-+
| |           |   | |         | |     |     |   | | |       | |     |   |       |     |       |   |     | | |   |   |   | |         | |     |
+ +-+-+-+-+ +-+-+ + +-+-+-+-+ + +-+-+-+ +-+-+-+ + + +-+-+-+ + + +-+ +-+ +-+-+ +-+-+-+ +-+ +-+ +-+ +-+-+ + + +-+ + +-+-+ + + +-+-+-+ + +-+ +-+
| | |   | | |   | |   | |   | | | | | |   |   |   |   | |         | | | | | |     |     | | |       |   |   |     |               |   | | | |
+ + + +-+ + +-+ + +-+ + + +-+ + + + + +-+ + +-+-+-+ +-+ + +-+-+-+-+ + + + + + +-+ + +-+ + + +-+-+ +-+ +-+-+ + +-+-+-+-+-+ +-+-+-+-+-+ + + + +
|     | |   | |         | | |     | |     |   |   | |   | | | |   |       |   |       | |       |   |     |         |         |         |   |
+-+ +-+ + +-+ +-+-+ +-+ + + +-+ +-+ +-+-+ +-+ + +-+ + +-+ + + + +-+-+-+ +-+-+-+-+-+ +-+-+-+-+-+-+-+ +-+-+ +-+-+-+ +-+-+-+-+-+-+-+ +-+-+-+ +-+
| | | |         |   | | | |   |   | | | | | |         |   |   |                     | | | | | |     |   |       |   | |   |   |   |     | | |
+ + + + +-+-+-+ +-+ + + + +-+ + +-+ + + + + +-+ +-+-+-+-+ +-+ + +-+-+-+-+-+-+-+-+-+ + + + + + +-+-+ +-+ +-+-+ +-+ +-+ + +-+ +-+ +-+-+-+ + + +
|   |         |     | |   | |     | |       |     |           |     | |   |   |     |             |     |   |             |     | |         |
+-+ +-+-+-+ +-+-+-+ + +-+ + +-+ +-+ +-+-+-+-+-+-+-+-+-+-+-+-+-+-+-+ + +-+ +-+ + +-+ +-+-+-+-+-+-+ + +-+ + +-+-+-+-+-+-+-+ +-+ +-+ +-+-+ +-+-+
|   |   |         |     |   | |   |           | |     |     |   |   | | | |     |       | |   | | |   |   | | |       |             |   |   |
+-+ + +-+-+-+-+-+-+-+-+-+-+ + + +-+-+-+ +-+-+ + +-+-+ + +-+ +-+ + +-+ + + +-+-+ +-+-+-+ + +-+ + + + +-+-+ + + +-+-+-+ +-+-+-+-+ +-+-+-+ +-+ +
|       | |           |     |   |       | |     |   |   | |   |               |     |         | | | |     |     |   | | |     | | | |       |
+ +-+-+ + + +-+-+-+-+-+-+-+ + +-+ +-+-+ + + +-+-+-+ +-+ + +-+ +-+-+-+-+-+-+-+-+-+-+-+-+ +-+-+ + + +-+-+ +-+ +-+ +-+ + + +-+-+ + + + + +-+-+-+
| | | |       | | |   |       | | | |   | |   | | |         | | |     | | |     |       | |   | |     |   |   |     |   | |   | | | |       |
+ + + + +-+-+ + + + +-+ +-+-+ + + + + +-+ +-+ + + +-+ +-+-+-+ + +-+ +-+ + +-+-+ + +-+-+ + + +-+ +-+-+ + +-+-+-+ +-+ + +-+ +-+ + + + + +-+-+-+
| |   |   |   | |     | | |     |   | | | | | |   | |     | |     |     |         | | |   | |       |   | |   |   | |   |       |     |   | |
+ +-+ + +-+-+ + +-+ +-+ + +-+-+ +-+-+ + + + + + +-+ +-+ +-+ +-+-+ +-+ +-+-+-+ +-+ + + +-+-+ +-+-+-+ +-+ + + +-+-+ + +-+ +-+-+-+-+-+-+ +-+ + +
|     |   |     |   |   | |   |   |   |   |   | | |   |         | |     | |   |       |   |   |   | |   | |       | |   |     |   | |   |   |
+-+-+-+-+-+-+ +-+-+ +-+ + +-+ + +-+-+ +-+ +-+ + + +-+ +-+-+-+-+ + + +-+ + +-+-+-+ +-+ + +-+ +-+ +-+ +-+ + + +-+-+-+ +-+ + +-+ + +-+ +-+ +-+ +
|     |       |     | | | |     |     |         |   |     |     | | |       |   | |       | | | | |       | |     | | |   | | |   |         |
+ +-+ +-+ +-+ +-+-+ + + + +-+ +-+-+-+-+ +-+-+-+ + +-+-+ +-+-+ +-+ +-+-+-+-+ +-+ +-+-+ +-+-+ + + + + +-+-+-+ +-+-+ + + +-+ + + +-+ +-+-+ +-+-+
| |   | |   |         |     | | |     |     | | | | | |   |   |               | |   | | |       |   |       |     |       |     |     | |   |
+-+ +-+ +-+ +-+-+-+-+ +-+-+ + + +-+ +-+-+-+ + + + + + + +-+-+-+-+-+-+-+ +-+-+ + +-+ + + + +-+-+-+-+ +-+ +-+ + +-+ +-+-+-+-+ +-+ +-+-+ + + +-+
|     |             | |     |     |   |   |   | |   | |   |       |     | | | |       | |         |       |   | |       |     | |     |   | |
+-+ +-+-+ +-+-+-+-+-+ +-+ +-+-+-+ + +-+-+ +-+-+ +-+ + + +-+-+-+-+ +-+ +-+ + + +-+ +-+ + +-+-+-+-+-+-+-+-+ +-+ + +-+-+-+-+-+ +-+ +-+ +-+-+ + +
|   |     | | |   |   | |   |   | | |     | | |   | | |   |       |         | | | |         |     |     |   |         | | |   |   |         |
+-+ +-+-+ + + +-+ + +-+ +-+ +-+ + + +-+-+ + + +-+ + + + +-+-+-+ +-+ +-+-+-+-+ + +-+-+-+ +-+ + +-+ +-+ +-+-+-+-+-+-+ +-+ + +-+-+-+-+-+ +-+-+-+
| | |           |             |           |             | | | |           |   |       | | |     |     | | |       |   | | |   | |   |   | | |
+ + +-+-+-+-+-+-+-+-+-+ +-+-+-+-+-+-+-+-+ +-+-+-+-+ +-+ + + + + +-+-+-+-+-+-+ +-+ +-+ + + +-+-+-+-+ +-+ + + +-+-+ + +-+ + +-+ + + +-+-+ + + +
|     |     | | |     | |     | | |   |     |       | | |         |     | |   |     | |       | | | | |   |   |     |   |       |   | |   | |
+-+ +-+-+-+ + + +-+-+ + +-+-+ + + + +-+-+ +-+-+-+ +-+ + +-+ +-+-+ +-+-+ + +-+ + +-+-+ +-+-+-+ + + + + +-+ +-+-+-+-+ + +-+ +-+-+ +-+ + + +-+ +
| | | |   |     |         | | |                 |   | |       |     |     |   |     |         |   | |   |   | |         | | |         |     |
+ + + +-+ +-+-+ +-+-+-+ +-+ + +-+-+-+ +-+-+-+-+ +-+ + +-+-+-+-+ +-+ +-+ +-+-+ +-+-+-+-+-+-+-+ + +-+ +-+ +-+ + +-+-+-+ +-+ + +-+-+-+-+ + +-+-+
|     |   |   |         |   | | |             | |   | |           | | |     |   |     |     |     | | |   | |     | |         |   |   | | | |
+-+-+ + +-+ +-+-+ +-+-+ + +-+ + +-+-+-+-+ +-+-+ + +-+ +-+-+-+-+-+-+ + +-+-+ + +-+ +-+ + +-+ + +-+-+ + +-+ + +-+-+ + + +-+-+-+ + +-+-+ + + + +
| |     | | |       |     |   | | |         |               | |   | |   |       |   |   | |       |   | |     | | | | |       |     | |     |
+ +-+ +-+ + +-+-+ +-+-+-+-+-+ + + +-+-+-+-+-+-+-+-+-+ +-+-+ + +-+ + +-+ +-+-+ +-+-+-+-+ + +-+-+-+-+ +-+ + +-+ + + + +-+-+-+ +-+ +-+ +-+-+ +-+
| |   | |                 |   | |   |   |     | |   | | |       |           |     | |     |       |     |   | | |         | |   |           |
+ +-+ + +-+-+-+ +-+-+-+-+ +-+ + +-+ + +-+-+-+ + + +-+ + +-+-+-+-+-+ +-+-+-+-+-+-+ + + +-+ +-+-+ +-+ +-+ + +-+ + + +-+-+-+ + +-+-+-+-+-+-+-+-+
|     | |     | |   |       |         |     |         |       | |       |     | | |   |   |   |     |       |           | |   | | | |     | |
+-+-+ + + +-+ + +-+ +-+ +-+ + +-+-+-+ + +-+ + +-+-+-+ +-+-+ +-+ +-+ +-+-+ +-+ + +-+-+ +-+ +-+ +-+-+-+ +-+-+-+-+-+-+-+-+-+-+-+-+ + + +-+-+ + +
|         | |   | |   | |   |       | | |   |   | | |           |     |   | |     |   |   |             | | |       | |     |     | | | |   |
+-+-+-+ +-+ +-+ + +-+ + +-+ +-+-+-+-+ +-+ +-+ +-+ + +-+-+-+-+-+-+-+ +-+ +-+ +-+-+ +-+-+-+-+-+-+-+-+-+ +-+ + +-+-+ +-+ +-+ +-+ +-+ + + + +-+ +
| |   |       | |     |   | |   |   | | |   |             |   |     |   | |       |     |     |   | | |       |     |           |           |
+ +-+ +-+-+-+-+ +-+ +-+-+-+ +-+ + +-+ + + +-+-+-+-+-+-+-+ + +-+ +-+ + +-+ +-+-+-+ +-+ +-+-+ +-+-+ + + +-+-+ +-+-+ +-+-+-+ +-+-+-+-+-+-+-+-+-+
|   | |   |   |   | | |       |       | |   |   | |       |   |   | |   |   |     | | |       |     | | |     | |         |   |   |   |     |
+ +-+ + +-+-+ +-+ + + +-+ +-+ +-+-+ +-+ + +-+-+ + +-+-+-+ + +-+-+ + +-+ +-+ +-+-+ + + +-+ +-+ + +-+ + + + +-+ + +-+-+ +-+ +-+ +-+ + +-+ +-+-+
|       |     |   |         |         | |   |   | |   | |       | |   |     |           |   |     | |       |       |   | |     | |   |     |
+-+ +-+ +-+-+ +-+-+-+-+-+-+-+-+ +-+-+ + +-+ +-+ + +-+ + +-+-+-+-+-+-+ +-+-+-+-+-+-+-+ +-+-+-+ +-+-+ +-+-+ +-+-+-+-+ +-+-+ +-+-+ + +-+ +-+-+ +
| |   | |   |   | |   |       | |   |       |   |   |     | |     |   |     | | |   | | | |       | |     |             | | |         | |   |
+ +-+ + + +-+-+ + + +-+-+-+-+ + + +-+-+-+-+ + +-+ +-+-+-+ + +-+ +-+-+ + +-+ + + + +-+ + + + +-+-+-+ +-+-+-+-+-+-+-+-+ +-+ + + +-+-+-+ + +-+ +
|     |                               |                           |       |                       |                 |             |         |
+-+-+-+-+-+-+-+-+-+-+-+-+-+-+-+-+-+-+-+-+-+-+-+-+-+-+-+-+-+-+-+-+-+-+-+-+-+-+-+-+-+-+-+-+-+-+-+-+-+-+-+-+-+-+-+-+-+-+-+-+-+-+-+-+-+-+-+-+-+-+