+-+-+-+-+-+-+-+-+-+-+-+-+-+-+-+-+-+-+-+-+-+-+-+-+-+-+-+-+-+-+-+-+-+-+-+-+-+-+-+-+
| |       |   |   | |                         |   | |   |         |           | |
+ +-+-+ +-+-+ + +-+ +-+-+-+-+-+-+-+-+ +-+-+-+ +-+ + + +-+ +-+-+-+ +-+-+-+ +-+-+ +
|               |   |     |           | |   |   | |     |     | | |   | | |   | |
+ +-+-+-+-+-+-+ + +-+-+ +-+-+-+-+ +-+ + + +-+ +-+ +-+ +-+-+ +-+ + + +-+ + + +-+ +
| | |                 | | |   |   | |   |       | | |   |       |       | |   | |
+ + +-+-+-+ +-+-+-+-+ + + + +-+-+ + +-+-+-+ +-+ + + +-+ +-+-+-+-+ +-+ +-+ + +-+ +
|   |       |     | | | |         |   |   |   |     |       |       |     |     |
+-+-+ +-+-+ + +-+ + + + + +-+-+-+ + +-+ +-+-+ +-+-+ + +-+-+-+-+-+ +-+-+-+ +-+-+ +
| |       | | | |     | |   |   | |     |         |     | |   |     |     |     |
+ +-+-+-+ +-+ + + +-+ + +-+ + +-+ + +-+ +-+-+-+ +-+-+-+ + + +-+-+-+ +-+-+ +-+ +-+
| |   |   | |   | |   | | | |         |     |     |   |   |   |         |     | |
+ +-+ +-+ + +-+ +-+-+ + + + +-+-+-+-+-+-+-+-+-+-+ + +-+ +-+-+ +-+-+ +-+-+-+-+-+ +
|   | | | |     | |   | | |   |           |         |           | |       | | | |
+-+ + + +-+-+ +-+ + +-+ + +-+ +-+-+-+-+ +-+-+-+-+-+ +-+-+-+-+-+ + +-+-+-+ + + + +
|   | | |   |     | |       | | | | | |           | | |     | | |   |   |   |   |
+-+ + + + +-+-+ +-+ +-+-+ +-+ + + + + +-+-+-+ +-+ + + +-+-+ + + +-+ + +-+ +-+-+ +
|                 |                 |   |       |   | |   |   | |       |     | |
+-+-+-+-+-+-+-+-+ +-+-+-+-+-+ +-+-+ + +-+-+ +-+-+-+ + + +-+-+ + + +-+-+ + +-+-+ +
| | | |       | |     |           |       | | | | | | |     |     |   | | | |   |
+ + + +-+-+-+ + + +-+-+-+-+-+-+-+-+-+-+-+-+ + + + + + + +-+ + +-+ +-+ + + + + +-+
|       |     |                   |         |       |     |     |     |   | | | |
+-+-+-+ +-+-+ +-+ +-+-+-+-+-+-+-+-+-+-+-+-+-+-+-+-+-+-+-+-+-+-+-+-+-+-+-+ + + + +
|         | |         |             |     | |   |     | |   |   |         |   | |
+ +-+-+-+ + +-+-+ +-+ +-+-+ +-+-+-+ +-+ +-+ +-+ +-+-+ + + +-+-+ + +-+-+-+ + +-+ +
| |     |   | | | |   | | | | |     |     | | | |   | |         |     | | |     |
+ + +-+ + +-+ + +-+-+ + + + + +-+ +-+ +-+ + + + + +-+ +-+ +-+-+ +-+ +-+ + +-+-+ +
| |   | | | |       |       |       |   |     |       |       |     | | |       |
+ +-+ + + + +-+ +-+-+-+-+-+-+ +-+-+ +-+-+ +-+ +-+ +-+ +-+-+ +-+-+-+ + + +-+ +-+-+
| | | | |     |     | |           |   | | |         |     | |     | |     | | | |
+ + + + +-+ +-+-+-+ + +-+ +-+-+-+-+-+ + +-+-+-+-+-+ +-+-+ + +-+ +-+ + +-+ + + + +
|   | |   |     | |     |   | |     |               | | | |     | | | |         |
+ +-+-+ +-+-+ +-+ +-+ +-+-+ + +-+ +-+-+-+-+-+-+-+-+ + + +-+-+ +-+ +-+-+ +-+-+-+-+
|     |   | | | | | | | |     |     | |   | |       |   |       |     |     |   |
+-+ +-+-+ + + + + + + + +-+ +-+-+ +-+ + +-+ + +-+-+ +-+ +-+-+-+ +-+-+ +-+ +-+ +-+
| |     |   | |       | |       | | |         | |   | |     |       |   | |     |
+ + +-+ + +-+ +-+-+-+ + +-+-+-+ + + +-+-+-+-+ + +-+ + +-+-+ + +-+-+-+ +-+ +-+-+ +
|     |     | |         |   | | |       |   |     | | |   | |           |   |   |
+-+-+-+ +-+-+ +-+-+ +-+ +-+ + + +-+-+ +-+ +-+ +-+-+ + + +-+ +-+ +-+-+-+-+-+ + +-+
|         | |         |     | | |   |     |   |         |     |       |     |   |
+-+-+-+-+ + +-+-+-+-+-+-+-+ + + + +-+-+-+ +-+-+ +-+-+-+-+ +-+ +-+-+-+-+-+ +-+ +-+
|   |         |   |               | |   | | |   |           | | |   | |   |   | |
+ +-+-+ +-+-+ +-+ + +-+-+-+-+-+-+ + +-+ + + +-+ + +-+-+-+-+-+ + +-+ + + +-+-+ + +
|   |       |     | |         |         | | |   |   |   | | | | | |   | |     | |
+ +-+-+-+-+-+-+ +-+ +-+-+-+ +-+ +-+-+-+ + + + +-+ +-+-+ + + + + + +-+ + +-+-+ + +
|           | |   | |       |   |     |     | |   |   | | |   |         | | |   |
+-+-+ +-+-+ + + +-+ +-+-+ +-+-+ + +-+ +-+-+ +-+-+ + +-+ + + +-+-+-+ +-+ + + + +-+
| |     | |   | |   |   | | |       |     |   | | |     | |     |   |   |     | |
+ +-+ +-+ +-+ + +-+ + +-+ + +-+-+-+-+-+-+-+-+ + + +-+-+ + +-+-+ +-+ +-+ +-+ +-+ +
|       | | | |   |             | |     |         |   |   |       | |   | | | | |
+-+-+-+ + + + +-+ +-+-+-+-+-+-+ + +-+ +-+-+-+-+-+ +-+ + +-+-+-+-+ +-+-+ + + + + +
| | |       |             |       | |       | | | |             |   |   | |   | |
+ + +-+-+-+-+ +-+-+-+-+-+-+-+-+-+ + +-+ +-+ + + + +-+-+-+-+-+-+ +-+-+ +-+ + +-+ +
|   | | | | | | |                 |     |       |       |         |   |   | |   |
+-+ + + + + + + +-+-+-+-+ +-+-+-+ + +-+-+-+-+-+-+ +-+-+ +-+-+-+ +-+-+ +-+ + + +-+
| | | |   | | |     |     | | |   |   | |   | |       |       | | | |     |     |
+ + + +-+ + + +-+ +-+-+-+ + + + +-+ +-+ + +-+ +-+ +-+-+ +-+-+ + + + +-+-+ +-+-+ +
|   |       | | | |   |   |   |     |   |             | |     | | |   |         |
+-+ +-+ +-+ + + + +-+ +-+ +-+ +-+-+ + +-+-+-+-+-+-+-+-+ +-+-+ + + +-+ +-+-+-+ +-+
|         |             |     |                   |         |               |   |
+-+-+-+-+-+-+-+-+-+-+-+-+-+-+-+-+-+-+-+-+-+-+-+-+-+-+-+-+-+-+-+-+-+-+-+-+-+-+-+-+