+-+-+-+-+-+-+-+-+-+-+-+-+-+-+-+-+-+-+-+-+-+-+-+-+-+-+-+-+-+-+
|   | | |   | |   | |   |     |       |       |   |   |     |
+-+ + + + +-+ +-+ + + +-+ +-+ +-+-+ +-+ +-+-+ +-+ + +-+-+-+ +
| | | | |                   | | |       |   |   | |       | |
+ + + + +-+-+-+-+ +-+-+-+-+-+ + +-+-+-+ +-+ + +-+ + +-+-+-+ +
| | |   |   | |       | | |   |       |   | |       |   | | |
+ + +-+ +-+ + +-+-+-+ + + + +-+-+-+-+ +-+ + +-+-+ +-+-+ + + +
|     |   |       |   | |   |         | |       |       |   |
+-+-+ + +-+ +-+-+ +-+ + + +-+-+-+-+-+ + +-+-+-+-+ +-+-+ + +-+
| | |   |     | |       |     |           |         | |     |
+ + + +-+ +-+ + +-+-+-+-+-+-+ +-+ +-+-+-+ +-+-+ +-+ + +-+-+ +
|     |   |           |   |     | | |     |     | | |       |
+ +-+ +-+-+-+-+-+-+-+ +-+ +-+ +-+ + +-+-+ + +-+ + +-+ +-+-+-+
|   | | |           |   | |   |   |       |   |   | |   |   |
+-+-+ + +-+-+-+-+-+ +-+ + + +-+-+-+-+-+ +-+-+-+-+ + + +-+ +-+
| | | | |   | |           |     | |   |       | |   |   |   |
+ + + + +-+ + +-+ +-+-+-+-+-+-+ + +-+ +-+ +-+ + +-+-+-+ + +-+
| | | |   |   |       |   |     |   |   |   | |     | | |   |
+ + + +-+ + +-+-+-+ +-+ +-+ +-+ + +-+-+ +-+-+ +-+ +-+ + +-+ +
| |     | |   |   |   |       |   |   |       |   |   | |   |
+ + +-+ + +-+ +-+ +-+ +-+-+-+-+-+ + +-+ +-+-+ + +-+ +-+ + +-+
| | |     |   |   | |   |     |   | | | | | |       |   |   |
+ +-+-+-+ +-+ +-+ + +-+ +-+-+ +-+ + + + + + +-+ +-+ + +-+ +-+
|       | | | |     | |   | |   |         | | |   |     | | |
+-+ +-+ + + + +-+ +-+ + +-+ + +-+-+-+-+-+ + + + +-+-+-+ + + +
| | |       |     |   |   |   | |     | |   |     | |       |
+ +-+ +-+-+ +-+ +-+ +-+ +-+ +-+ +-+-+ + +-+-+-+-+ + + +-+-+-+
|       |   | | |   | |       | |   |             |         |
+ +-+-+-+-+ + + + +-+ +-+ +-+ + + +-+-+-+-+-+-+ +-+-+-+-+-+-+
|         |   |         |   | |   | | |       |   |   |     |
+-+-+-+-+ + +-+-+-+-+ +-+-+ +-+ +-+ + +-+-+ +-+-+ + +-+-+ +-+
| |       | | | | | |   | |     | |     |         |   |     |
+ +-+-+-+ + + + + + + +-+ + +-+ + +-+ +-+-+-+-+-+ + +-+-+ +-+
|   |   | |     |         |   |       | | | |   |   | | | | |
+ +-+ +-+-+-+ +-+ +-+-+-+ +-+-+-+ +-+ + + + + +-+ +-+ + + + +
| | |     |   |       |   | |       | |     | |             |
+ + + +-+ +-+ +-+-+-+ +-+ + +-+-+-+ +-+-+ +-+ +-+-+ +-+-+-+-+
|     |       |   |     | |   | | | | | | |               | |
+-+-+-+ +-+-+ +-+ + +-+-+ + +-+ + + + + + +-+-+-+ +-+-+-+-+ +
|           | | |   | |           | |     | |     |         |
+-+-+ +-+-+-+ + + +-+ +-+ +-+-+-+ + +-+-+ + + +-+ + +-+-+-+-+
|   |   | | |         |       |   |         |   |     | |   |
+ +-+ +-+ + +-+-+-+-+-+-+-+-+-+-+ +-+-+-+-+-+ +-+-+-+ + +-+ +
|   | |   | |           | |   |   |         |       | |     |
+ +-+ + +-+ +-+-+-+-+-+ + +-+ +-+ + +-+-+-+ +-+-+-+ + +-+-+ +
|     | | | | |   |   |   |   | |         |       | |       |
+-+-+ + + + + + +-+ +-+ +-+ +-+ + +-+-+-+ +-+-+-+ +-+-+ +-+-+
|         |   | |   |     | | |       | | | |   | |       | |
+-+ +-+-+ + +-+ + +-+ +-+ + + + +-+-+ + + + +-+ + +-+ +-+-+ +
|   |       |   |       | | |   |   | |     | |         | | |
+-+ +-+-+-+ +-+ +-+-+ +-+ + + +-+ +-+-+-+-+ + +-+-+-+ +-+ + +
|         | |   | |   | |     | | |     | |         | |     |
+-+ +-+-+-+ +-+ + + +-+ +-+ +-+ + +-+-+ + +-+-+-+-+ + +-+ +-+
| |   |       |       | | | |   | |   | |     | | | |   |   |
+ +-+-+ +-+-+-+-+-+-+ + + + + +-+ + +-+ +-+ +-+ + +-+ +-+ +-+
| |   | | | |   | | | |   |   | |           |     |   | |   |
+ + +-+ + + +-+ + + + + +-+ +-+ +-+-+-+ +-+ +-+-+ + +-+ +-+ +
|   | |       | |   |     |       |       |   | | | | |     |
+ +-+ + +-+-+ + +-+ +-+-+-+ +-+-+-+-+-+ +-+-+ + + + + +-+-+ +
|     |     | |     | |       | |   |       |           |   |
+-+ +-+-+ +-+ +-+ +-+ +-+-+ +-+ +-+ +-+-+-+-+ +-+-+-+-+-+ +-+
|           | |         | | | |         |     | | |       | |
+-+-+-+ +-+-+-+-+ +-+-+ + + + +-+-+-+ +-+ +-+ + + +-+-+-+ + +
|     |         | |           |     |       | | |         | |
+ +-+-+-+-+-+-+-+-+-+-+-+-+-+ + +-+ + +-+-+-+ + +-+-+-+ +-+ +
| |         |   |         |       | |       | | | |       | |
+ +-+ +-+-+ +-+ +-+-+-+-+ +-+-+-+-+ +-+-+-+-+ + + +-+ +-+-+ +
| |     |         | | | |   |     | |             |   |   | |
+ + +-+-+-+-+-+ +-+ + + +-+ + +-+-+-+-+ +-+-+-+-+ +-+ + +-+ +
|   |     |   |             |   |               | |       | |
+ +-+-+ +-+-+ +-+ +-+-+-+-+ + +-+-+-+-+-+-+-+-+-+ +-+-+-+ + +
| |               | | |           |                   |   | |
+-+-+-+-+-+-+ +-+ + + +-+-+-+-+-+ + +-+-+-+-+-+-+-+-+ + +-+ +
|           | | | | | |   | |           | | | | |   | | | | |
+-+-+ +-+-+ + + + + + +-+ + + +-+-+-+-+ + + + + +-+ + + + + +
| | | |   |   | |   |   | |   | | |   |   |       | |       |
+ + + +-+ + +-+ +-+ + +-+ + +-+ + + +-+ +-+-+-+ +-+ +-+ +-+-+
| | | |       |         |       |   |           |   |   | | |
+ + +-+-+-+-+-+-+-+-+-+-+-+-+-+ + +-+-+-+-+-+ +-+ +-+ +-+ + +
|                                     |             |       |
+-+-+-+-+-+-+-+-+-+-+-+-+-+-+-+-+-+-+-+-+-+-+-+-+-+-+-+-+-+-+