+-+-+-+-+-+-+-+-+-+-+-+-+-+-+-+-+-+-+-+-+-+-+-+-+-+-+-+-+-+-+-+-+-+-+-+-+-+-+-+-+-+-+-+-+-+-+-+-+-+-+
| |   | |   |   |     |   |       |   |           |       | |     |   |   | |   |     |   |   |     |
+ +-+ + +-+ + +-+ +-+ +-+ +-+-+-+ +-+ +-+-+-+ +-+ +-+-+ +-+ +-+ +-+ +-+ +-+ + +-+-+-+ +-+ + +-+-+ +-+
| | | | |   | |     | |             | |   |     |         | |     | |       | | | |           |     |
+ + + + + +-+ +-+-+-+ +-+-+-+-+-+ +-+ + +-+-+ +-+-+-+-+-+ + +-+-+ + +-+-+ +-+ + + +-+-+-+-+-+ +-+ +-+
| |         | | |   |   |     |       |         | |       |           |     |     |     |     | |   |
+ +-+-+ +-+ + + + +-+-+ +-+-+ +-+ +-+ +-+-+-+ +-+ + +-+-+ + +-+-+-+ +-+-+-+ +-+-+ +-+-+ +-+-+ + +-+ +
|   | | |     |   | | |         | |   | | |       |     |   | |   | | |       |       |     |       |
+ +-+ +-+-+ +-+ +-+ + +-+-+-+-+ + +-+-+ + +-+-+ +-+-+-+ +-+-+ + +-+ + + +-+-+ + +-+-+ +-+ +-+-+-+ +-+
| |           |     |       |   | |   |             | |     |               | | |       |         | |
+ +-+ +-+-+-+ + +-+ +-+ +-+ + +-+ + +-+-+-+-+-+-+ +-+ +-+-+ +-+-+-+-+-+-+-+-+-+ +-+-+-+ +-+-+ +-+-+ +
| |     |     |   | |   |   |     |     |         | |   |     | |     |     | |   |     |       |   |
+ +-+ +-+-+ +-+-+-+ +-+ +-+ +-+-+ +-+ +-+-+-+ +-+ + + +-+-+-+ + + +-+ +-+-+ + +-+-+-+-+ +-+ +-+ +-+ +
|   | |     |       |     |   | |           |   |     |     |   | |   | | |               | |   |   |
+-+ +-+ +-+ + +-+-+ +-+-+ +-+ + +-+-+-+ +-+-+-+-+ +-+ +-+ +-+ +-+ +-+ + + + +-+-+-+-+-+-+ +-+ +-+-+ +
| | |     |     |   |     | | |   |     |     | | |     |   |   | | | |   |             | |   |     |
+ + +-+-+ + +-+-+-+ +-+-+ + + + +-+-+ +-+-+-+ + +-+ +-+ +-+ + +-+ + + + +-+ +-+-+-+-+-+-+ +-+ +-+-+ +
|         |   |     |       | | | | |     |   |   |   |     |     |   |   |       | | | |         | |
+-+-+-+-+ +-+-+-+-+ +-+-+ +-+ + + + +-+-+ +-+ +-+ +-+-+-+ +-+ +-+-+ +-+-+ + +-+-+ + + + +-+ +-+-+-+ +
| |   |           | | | | |       |   |     |   |   |   | | |     |         | |   | | | | |         |
+ +-+ +-+-+-+ +-+-+ + + + + +-+-+ + +-+-+-+ + +-+-+ + +-+ + +-+-+-+-+ +-+-+ + +-+ + + + + +-+-+ +-+-+
| | |   |     | |   | | | | |   | | |       |   | |               |   |     |       |   | |         |
+ + + +-+ +-+ + +-+ + + +-+ + +-+ + +-+ +-+ + +-+ +-+-+-+-+-+-+-+-+-+-+-+-+-+-+-+ +-+ +-+ +-+ +-+-+-+
| | | |   | |     | |     |   |   |     | |   |     |           |           | |     |               |
+ + + +-+ + +-+-+ + +-+-+ +-+-+ +-+-+-+ + + +-+-+-+ +-+-+-+-+ +-+-+ +-+-+-+ + +-+-+-+-+ +-+-+-+-+-+-+
|   | | |   |   | | |     |   |       | |       |     |         |   | | |   | |       | |           |
+-+ + + + +-+ +-+-+ + +-+ + +-+ +-+-+ +-+-+-+ +-+ +-+ +-+-+-+ +-+-+ + + + +-+ +-+ +-+ + + +-+-+-+-+-+
| |     |   | |     |   |           | | |     |   |       |   |     | |       | | | | |     |   |   |
+ + +-+ + +-+ + +-+ +-+-+ +-+-+-+-+-+ + +-+-+ +-+ +-+-+-+ +-+ +-+-+ + +-+ +-+ + + + + +-+-+ +-+ + +-+
|   | | | | |   | | |   | | | | | |   |       | |   |           |   | | |   |     |               | |
+-+ + + + + + +-+ + + +-+ + + + + +-+ +-+-+ +-+ +-+-+-+-+ +-+-+ + +-+ + +-+-+-+-+-+-+-+-+-+ +-+-+-+ +
| | |   |   | |     | |   | | |   |   |         |           |     |       |         | | |           |
+ +-+-+ + +-+-+-+-+ + + +-+ + +-+ +-+ + +-+-+-+ +-+-+-+-+-+-+-+-+ +-+-+ +-+-+-+-+-+ + + +-+-+-+-+ +-+
| |   |         | |       |   | |     |       |             |   | |       |           |     |       |
+ +-+ +-+-+ +-+ + +-+ +-+ + +-+ + +-+-+-+-+-+-+-+ +-+-+-+-+ + +-+ +-+ +-+ +-+-+-+ +-+ +-+ +-+-+-+ +-+
| |       |   |   | |   | | | |       |     |   | | | |   |       |   |   | |     |   |   |   |   | |
+ +-+ +-+ +-+ +-+ + +-+-+ + + +-+ +-+ +-+ +-+ +-+ + + + +-+ +-+-+ +-+ + +-+ + +-+-+-+ +-+ + +-+-+ + +
|       |   |   | | | |         |   |       |         | | |     |     |         |         |       | |
+ +-+-+-+-+ +-+ + + + +-+ +-+-+-+ +-+-+-+-+ +-+-+ +-+ + + +-+-+-+-+ +-+-+-+-+-+-+ +-+-+-+-+-+-+-+-+ +
|   |         | |   | |   | |   |   |       | |     | | | |     | |             |     | |     | | | |
+-+-+-+-+-+ +-+-+ +-+ + +-+ +-+ +-+ +-+-+-+ + + +-+-+ + + + +-+ + +-+ +-+-+-+-+-+-+-+ + +-+-+ + + + +
| |   |     | | | | | |   | |   |   |   |   |       |   | | |   |     | | |       | |   | | | |     |
+ + +-+-+-+ + + + + + +-+ + +-+ +-+ + +-+ +-+-+-+-+-+ +-+ + +-+ + +-+ + + +-+-+-+ + + +-+ + + +-+-+ +
| | |   |   |   |       | | |   | |     | |           |     |   | | | | | | | |   |     | | |       |
+ + +-+ + +-+-+ +-+-+-+ + + + +-+ + +-+-+ + +-+-+-+-+ +-+-+ +-+ + + + + + + + + +-+-+-+ + + +-+-+ +-+
|           | | |   |   |         |   | |   |     | | |       |   | | |             |     | |       |
+-+-+-+-+-+ + + +-+ +-+-+-+-+ +-+-+-+ + + +-+-+-+ + + +-+-+-+-+-+ + + +-+-+-+ +-+-+ + +-+ + +-+ +-+-+
| | | | |         |               | | |         |     |   |     |   |   | |   |       |     | | |   |
+ + + + +-+-+-+ +-+-+-+-+ +-+-+-+ + +-+-+-+ +-+-+-+-+ +-+ + +-+ + +-+-+ + +-+-+-+-+-+-+ +-+-+ + +-+ +
|   |     | |   |   |       | |   | | |       | |   |       |   |     |     |     | | |           | |
+-+ +-+-+ + +-+ + +-+-+-+-+ + + +-+ + + +-+-+ + + +-+-+-+-+-+ +-+-+-+-+-+-+ + +-+ + + +-+-+-+ +-+-+ +
|       | |         |   |     | |   | |     |               |         |   |   |       | | | |   |   |
+-+-+-+ + +-+ +-+-+ +-+ +-+-+ + + +-+ +-+-+-+-+-+-+-+-+-+-+-+-+-+ +-+ + +-+-+ +-+-+-+ + + + +-+ + +-+
| |             | |     | | | | |   |   |   |   |             |   |         |   |   |     |       | |
+ +-+-+-+-+-+ +-+ + +-+ + + + + +-+ + +-+ +-+-+ +-+ +-+-+-+-+ +-+-+-+-+ +-+-+-+ + +-+-+-+ +-+-+-+-+ +
|   |             | |   | |   | |   |   |   |   |   |           |     | | |   | | | | | |           |
+ +-+ +-+ +-+-+-+-+-+-+ + + +-+ + +-+ +-+-+ +-+ + +-+-+-+-+-+-+-+ +-+ + + +-+ + + + + + +-+-+ +-+-+-+
|   |   | |   |   |     | |   |         | |   |             | |   | | |   |   | |     | |     |   | |
+-+ +-+ + +-+ +-+ + +-+ + +-+ +-+ +-+-+ + +-+ +-+-+-+ +-+-+ + + +-+ + + +-+ +-+ + +-+ + +-+-+ +-+ + +
| | |   | |   |   |   | |       |     |   | | | |     |     |       | | |   |   |   |           |   |
+ + +-+ + + +-+-+ +-+ + +-+-+-+-+ +-+-+-+ + + + +-+-+-+-+ +-+ +-+-+-+ + + +-+-+-+-+-+-+-+-+-+ +-+ +-+
|       | |   |     | |   | | | | |   | |                 |   |     |     |   |         | |   | |   |
+-+ +-+-+ +-+ + +-+ + +-+ + + + + + +-+ +-+-+-+-+ +-+-+-+-+-+ +-+ +-+ +-+ +-+ + +-+-+-+ + + +-+ + +-+
| |   |   | |   |   | | |       |   | | |     |       | | |   | |     | |       |   |   | |         |
+ +-+ +-+ + +-+ +-+ + + +-+-+ +-+-+ + + + +-+ + +-+-+ + + + +-+ +-+ +-+ +-+ +-+-+-+ +-+ + +-+ +-+-+-+
| |   |   |       |         |         |   |     |   |     |   | |     | |             |   | |     | |
+ +-+-+-+-+-+-+-+-+-+-+-+-+-+-+-+-+-+-+-+-+-+ +-+ +-+-+-+ +-+ + +-+-+ + +-+-+ +-+-+-+-+-+ + + +-+-+ +
|     | | |   |     | |     |     | |           |       | | |       |   | |   | |   |     | | |     |
+-+-+ + + + +-+-+ +-+ + +-+-+-+ +-+ +-+ +-+-+-+ + +-+-+ + + +-+-+ +-+-+ + +-+ + + +-+ +-+ + + +-+-+ +
| |   |   |   |   |   | |               | |       |     |   | |     | |     |   | |     | |   |   | |
+ + +-+-+ +-+ +-+ + +-+ +-+-+-+-+-+-+ +-+ +-+-+-+-+-+-+ +-+ + + +-+ + + +-+-+-+-+ +-+-+-+-+ +-+-+ + +
|         | | |   | |         | |               |       |   |     |   | | | | | | |         |       |
+-+-+-+-+ + + +-+ + +-+-+ +-+ + +-+ +-+-+-+-+-+-+-+-+-+-+-+-+-+-+-+-+-+ + + + + + +-+-+ +-+ + +-+-+-+
|   |                 |   |       | | |   |     | |     |   | |   | | |           | | |   | |   |   |
+-+ +-+ +-+-+-+-+-+-+-+-+-+ +-+-+ + + + +-+-+ +-+ + +-+ +-+ + + +-+ + +-+-+-+-+ +-+ + + +-+ + +-+ +-+
| | |   |   | |     |       | | | |       |     |   |     | | | | | |       |       | |   |         |
+ + +-+ + +-+ +-+-+ +-+-+-+ + + + +-+-+ +-+-+-+ +-+ +-+-+ + + + + + +-+-+-+ + +-+-+ + +-+ +-+-+-+-+-+
| | | | |   |                   | |           |   |   | |   | |       | |   |   |   | | |       |   |
+ + + + + +-+-+ +-+-+-+-+-+-+-+-+ + +-+-+-+-+-+ +-+-+ + + +-+ +-+-+-+ + + +-+-+-+-+ + + +-+ +-+ +-+ +
|   |     |     | |   | |   | |       |   |       |   |   |               | |       | | |   |       |
+ +-+-+-+ +-+-+ + +-+ + + +-+ + +-+ +-+ +-+-+-+-+ +-+-+-+ +-+-+-+ +-+-+-+ + +-+-+-+ + + + +-+-+-+-+-+
|   |         | | | |       |     | |       | |   |   | | |     |   |                 |           | |
+ +-+-+-+-+ +-+ + + +-+ +-+ +-+-+-+ +-+-+ +-+ + +-+-+ + + +-+ +-+-+-+-+ +-+-+-+-+-+-+-+-+-+-+-+-+-+ +
| | |     |           |   |             |         | |           | |   | | | |       |       |       |
+ + +-+-+ +-+-+-+-+-+-+-+ +-+-+ +-+-+-+ +-+-+-+ +-+ +-+-+-+-+-+ + +-+ + + + +-+-+ +-+-+-+ +-+-+-+-+ +
|   |   |       | |     |     |     |     | |     | | |       | | |   |   | |       |   |   | |   | |
+ +-+ +-+ +-+-+ + + +-+ +-+-+-+-+-+-+-+ +-+ +-+ +-+ + +-+-+ +-+ + +-+ + +-+ + +-+-+ + +-+ +-+ +-+ + +
| | | |     |       |     |     | | | |         |   |       |           |     | |   |   | |         |
+ + + +-+-+-+-+-+-+-+ +-+ +-+ +-+ + + +-+ +-+-+ + +-+ +-+-+ +-+-+-+-+ +-+-+ +-+ + +-+ +-+ +-+-+-+-+ +
|   | | | | | | | | |   |   | |   |   | | |   | |     |     |     | | |       |   | | |     |       |
+-+ + + + + + + + + + +-+-+ + +-+ + +-+ + + +-+ +-+-+-+-+ +-+-+-+ + + + +-+-+-+-+ + + +-+-+ +-+-+-+ +
|   | |           |       |   | |   |   | | | |   |         |           |   | | |     | |     |     |
+ +-+ +-+-+-+-+-+ +-+-+-+-+-+ + + +-+ +-+ + + + +-+-+-+-+ +-+-+-+-+-+-+ +-+ + + +-+-+ + + +-+ +-+-+ +
|       |     | |         |   |   |   | |   |           |     |   |       | |   |         | |   | | |
+ +-+-+ +-+-+ + +-+-+ +-+ +-+ + +-+-+ + +-+ +-+-+-+-+-+ +-+ +-+-+ + +-+-+ + +-+ +-+-+ +-+ + +-+ + + +
| | |   | |       |   | |       |       |         |         |     |     |       |   | |       |     |
+ + +-+ + + +-+-+ + +-+ + +-+-+ +-+ +-+ +-+ +-+-+-+-+-+-+-+ +-+-+ + +-+-+-+-+-+ +-+ +-+-+-+-+-+ +-+-+
|   |     |     |       | |     |     |             |   |     | |   | |     | |     |     |     |   |
+-+-+-+ +-+ +-+-+-+-+-+ +-+-+-+-+-+-+-+-+-+-+-+ +-+ + +-+ +-+ + + +-+ +-+-+ + +-+ +-+ +-+ +-+ +-+ +-+
|                   |                             | |       |   |               |       |   |       |
+-+-+-+-+-+-+-+-+-+-+-+-+-+-+-+-+-+-+-+-+-+-+-+-+-+-+-+-+-+-+-+-+-+-+-+-+-+-+-+-+-+-+-+-+-+-+-+-+-+-+