+-+-+-+-+-+-+-+-+-+-+-+-+-+-+-+-+-+-+-+-+-+-+-+-+-+-+-+-+-+-+-+-+-+-+-+-+-+-+-+-+-+-+-+-+-+-+-+-+-+-+-+-+-+-+-+-+-+-+-+-+
|     |     |     |           |   |   | | | |     | | |   | | |   | |       | |   |   | |         |   |         |       |
+-+-+ +-+-+ +-+ +-+ +-+-+-+-+ + +-+ +-+ + + +-+-+ + + + +-+ + +-+ + +-+-+-+ + + +-+ +-+ +-+ +-+-+ +-+ +-+-+-+-+ +-+-+-+ +
|     |     |             |   | |               | | | |     |   |               |   | |     |     | | |   |             |
+ +-+ + +-+ +-+-+-+-+-+-+ +-+ + +-+-+-+-+-+ +-+ + + + + +-+ + +-+-+-+ +-+-+-+-+ +-+ + +-+-+-+-+ +-+ + + +-+-+ +-+-+-+-+-+
|   | | | |               |           |       | |   |     | |   |       |     | | |     | |     | | |               |   |
+-+ + + + +-+-+-+-+-+-+-+-+-+-+ +-+-+ +-+ +-+-+ + +-+-+-+ + +-+ + +-+-+ + +-+ + + + +-+ + + +-+ + + +-+-+-+-+ +-+-+ + +-+
|   |     |           | |     | | |         | | |   |   | | | | | |     |   | | |   |   | |   |               |     |   |
+ +-+-+-+ +-+-+-+ +-+ + +-+ +-+ + +-+-+-+-+ + + + +-+ +-+ + + + +-+-+ +-+ +-+ + +-+-+-+ + +-+-+ +-+-+-+-+-+-+-+-+-+ +-+ +
|     |   |   |   |     | |           |       | | | |   | |       | |   | |   | | | |       | |   |   |   |     | |   | |
+-+-+-+-+ + +-+ +-+-+-+ + +-+-+-+-+-+-+-+-+-+-+ + + + +-+-+ +-+-+ + +-+ +-+-+ + + + + +-+-+ + +-+ +-+ + +-+ +-+ + +-+ + +
|     | | |   | | | |     |         |   | | |   |       | |     | |     | | | | | | |     | |     | |       |           |
+ +-+ + + +-+ + + + +-+-+ +-+ +-+-+ +-+ + + +-+ +-+-+-+ + +-+-+-+ + +-+ + + + + + + +-+ +-+ +-+ +-+ +-+ +-+-+-+-+-+-+-+-+
|   |     | |       |     |   |     |   | | | |   |     | | | |       |   | |     |     |   |   |                     | |
+-+-+-+-+ + +-+-+ +-+-+-+ +-+ +-+-+ + +-+ + + + +-+-+ +-+ + + +-+-+-+-+ +-+ +-+-+ + +-+-+-+-+-+-+-+-+-+-+ +-+-+-+-+-+-+ +
|     | |     | |   | | |         | | | |     | |     |             |     | |   |         |     |         |     | |     |
+-+-+ + + +-+ + +-+ + + +-+ +-+-+-+ + + + +-+ + +-+ +-+-+-+-+-+-+-+ +-+-+ + +-+ +-+-+-+ +-+-+ +-+ +-+-+-+ + +-+ + + +-+-+
|   |       | | | | | | |       |   |   | | |     | |   |   | | | | |   |   |   | | |         |         |     |   |     |
+ +-+-+-+-+ + + + + + + +-+-+-+-+ +-+ +-+ + +-+-+ + +-+ + +-+ + + + +-+ + +-+ +-+ + + +-+-+-+ +-+-+-+-+ +-+-+-+-+-+ +-+-+
| | |       | | |     |   |   |   |   |       |   |     | |   |   | | |   |   |     | |   |               |   | |     | |
+ + + +-+-+-+ + + +-+ +-+ + +-+-+ + +-+-+-+ +-+-+ +-+ +-+ + +-+-+ + + +-+ +-+ +-+-+ + +-+ +-+-+-+ +-+-+-+ +-+ + +-+ +-+ +
| | |   | |     | |   |     | | |       | |     |       |       |   |   | |     |         |         |   | |   |     | | |
+ + + +-+ + +-+ + +-+ +-+-+ + + +-+ +-+-+ + +-+-+-+-+-+ +-+-+ +-+-+ +-+ + + +-+ +-+-+-+-+-+-+-+ +-+ + +-+ +-+ +-+-+ + + +
| |       | |     |               | |       | |   |             |             |       |           |     |     | | | | | |
+ +-+-+-+-+-+-+-+-+-+ +-+-+-+-+-+-+-+-+-+-+ + + +-+-+-+ +-+-+-+-+-+-+-+-+ +-+-+-+-+-+-+-+-+-+-+-+-+-+-+-+-+-+ + + + + + +
|         |   | |     |     |       |     | | | | |           |     |     |                 |     |     | |   |   |   | |
+ +-+-+-+ + +-+ +-+ +-+ +-+ +-+-+-+ +-+-+ + + + + +-+-+-+ +-+ +-+ +-+ +-+ +-+-+-+-+-+-+-+-+ +-+-+ +-+ +-+ +-+ + +-+ +-+ +
| |               | |   | | | | |             |   |       | |       |   |   |   | |           | | |     |   | | | |     |
+-+-+-+ +-+-+-+-+ + +-+ + + + + +-+-+-+-+-+ +-+-+ +-+-+ +-+ +-+ +-+ +-+ +-+ +-+ + +-+-+-+-+-+ + + +-+-+ + +-+ + + +-+ +-+
|   | |   | |   |     | |   |   |     | |       | |       |     |       |   |           | |     | |         |       | | |
+ +-+ + +-+ +-+ +-+ +-+-+-+ + +-+-+ +-+ +-+-+ +-+ +-+-+-+-+-+-+-+-+ +-+-+-+-+ +-+-+-+-+ + +-+ +-+ +-+-+-+ +-+ +-+-+ + + +
|   |     | | | | | | |   | |     |         | |   |     | |       | |           |     | | |   | | | |   |         | |   |
+ +-+-+-+ + + + + + + + +-+ +-+ +-+-+-+-+ +-+ + +-+-+-+ + + +-+-+ + +-+ +-+-+-+ +-+ +-+ + + +-+ + + +-+ +-+-+ +-+ + + +-+
| |     |       |   |   | |   |     |     | | |     |           |         |   |     | |               |         | | |   |
+ +-+ +-+-+ +-+-+-+-+ +-+ + +-+ +-+-+ +-+ + + +-+ +-+-+-+-+-+-+ +-+-+-+ +-+ +-+-+ +-+ +-+-+-+-+ +-+-+-+-+-+-+-+-+-+-+ +-+
|   |           |       |   |     | | |       |   | | |           |     | |   |     |   | |   |   |               |   | |
+-+ +-+ +-+-+-+ +-+-+ +-+ +-+-+-+ + +-+-+ +-+ + +-+ + + +-+-+-+-+-+-+-+ + + +-+-+ +-+ +-+ +-+ +-+ +-+-+-+ +-+-+-+ +-+ + +
|           |   |     |         |   | |     |   |   | | | | |   |       | | |   | |     | |               |           | |
+-+-+-+-+-+-+-+ +-+ +-+ +-+-+-+-+-+ + + +-+-+-+ + +-+ + + + + +-+-+-+ +-+ + + +-+ +-+-+ + +-+ +-+-+-+-+-+ +-+-+-+-+-+-+ +
|       | |               | | | |           |   |   |     |     | | |     |     | |               |       | |   | |   | |
+-+ +-+ + +-+-+-+-+-+-+-+ + + + +-+-+-+-+-+-+ +-+ +-+-+ +-+-+ +-+ + +-+-+ + +-+ +-+-+ +-+-+-+-+-+-+-+-+-+ + +-+ + + +-+ +
| | |             |   |           | |   | |         | | |           |   |     | |   | |     | |           |         | | |
+ +-+-+-+-+-+-+ +-+ +-+-+ +-+-+-+ + +-+ + +-+-+ +-+ + + +-+-+-+-+ +-+-+ + +-+-+ +-+ + +-+-+ + +-+-+ +-+-+-+-+-+ +-+ + + +
|   |     |   |       |   |   | |   | |       | |   |     |   |       | | | | |     | |     |       | | |         |   | |
+ +-+-+ +-+ +-+ +-+-+ + +-+-+ + + +-+ +-+-+-+ +-+-+ +-+-+ + +-+-+-+ +-+ + + + +-+-+ + +-+ +-+-+-+-+ + + +-+-+-+-+-+-+ + +
|         |   | |         |   |       |     |         | |   | |       | |   |       |   |       | | | |   | |       |   |
+-+ +-+-+ + +-+-+ +-+-+-+ +-+ +-+ +-+ +-+ +-+-+-+ +-+ + + +-+ +-+-+-+ + +-+-+-+-+-+-+ +-+-+ +-+ + + + + +-+ +-+-+-+ + +-+
| | | |     |   |       | | | | | |         | | | | | | |     |     | | | |   |       | |     |       | |   | |         |
+ + + +-+-+ + +-+ +-+-+ + + + + +-+-+-+-+-+ + + + + + + + +-+ + +-+ + + + +-+ +-+-+-+ + + +-+-+-+-+-+ + +-+ + +-+ +-+-+-+
|   | | |         |   | | | |         | |   |   | | | | |   | |   | |   |   |   |       | | |     |   | |           |   |
+-+ + + +-+-+ +-+ + +-+ + + +-+-+-+ +-+ +-+ +-+ + + + + + +-+-+-+-+ + +-+-+ +-+ +-+-+-+ + + +-+ +-+ +-+ +-+ +-+-+-+ + +-+
| | |           | | | | | |             |   | | | | |   | |           | |         |   | | |             |         |     |
+ +-+-+-+ +-+-+-+ + + + + + +-+-+-+-+-+ +-+ + + + + +-+ + + +-+-+-+-+ + + +-+-+-+ +-+ +-+-+-+-+-+ +-+-+ +-+-+-+-+ +-+-+-+
|             |       | |     | |       |       | | |   | |     |   |       | |   |           | | |         | |     |   |
+-+-+-+ +-+-+-+-+-+-+-+-+-+-+ + +-+-+-+-+-+-+-+-+ + +-+ + +-+-+ + +-+-+ +-+ + + +-+-+-+ +-+-+ + +-+-+ +-+-+ + + +-+ +-+ +
|             |   |   | | |   |   |     |         | |   | |           | |   |   | | | |   |   |         | | |   | | |   |
+-+-+-+ +-+-+ +-+ +-+ + + +-+ + +-+-+-+ +-+-+-+ +-+ + +-+-+-+-+ +-+-+-+-+-+-+-+ + + + +-+-+ +-+-+-+ +-+ + + + +-+ + + +-+
|           |           |   |       | |       |   | |     |   | | | |         | |   |   | |         |     | |   |   |   |
+-+-+-+-+-+-+-+-+-+-+-+ +-+ +-+ +-+ + +-+-+ +-+-+ + +-+-+ +-+ + + + +-+-+ +-+ + +-+ +-+ + +-+-+-+-+-+-+-+ + +-+-+-+ + +-+
| | |   |               |     |   | |   |     |   |   |   |   | |   |     | |     | | |       |           | |   |     | |
+ + + +-+-+-+-+-+-+ +-+ + +-+ + +-+ +-+ +-+-+ + +-+ +-+ +-+ +-+ + +-+-+-+ + +-+ +-+ + +-+-+-+ +-+ +-+-+-+-+ +-+ + +-+-+ +
|   |   | |     |   |       | | |   |     |       | | | | | |     |           | |     | | | |   | | |   |   |   |   | | |
+ +-+-+ + + +-+-+-+-+ +-+-+-+-+-+-+ +-+ +-+-+ +-+ + + + + + +-+-+-+-+-+-+-+-+-+ + +-+ + + + + +-+ + + +-+-+ +-+ + +-+ + +
|               |   | | |       |   | | | |   |   | |     |     | | |   | |   | |   |   | |   | |   |   | |     |     | |
+-+-+-+-+ +-+-+ + +-+ + +-+-+-+ +-+ + + + + +-+-+ + + +-+ + +-+ + + + +-+ + +-+ + +-+-+ + + +-+ +-+ + +-+ +-+-+ +-+ +-+ +
| |   |       |           | |   | |       |     |   |   | |   |   |     |   |   |     |           | |             |     |
+ +-+ +-+-+-+-+-+-+-+ +-+ + + +-+ +-+-+-+-+ +-+-+-+-+-+-+ +-+-+ +-+-+-+ +-+ +-+ + +-+-+-+-+-+-+-+ + +-+-+-+-+-+-+ +-+-+ +
| | | |     | | | |     | |   | |       |     | |   |     |     |       | | | | | | |   |               |     |         |
+ + + +-+ +-+ + + +-+ +-+-+-+ + +-+ +-+-+ +-+ + + +-+ +-+-+-+ +-+-+ +-+ + + + + + + +-+ +-+-+-+-+-+-+-+ +-+ +-+-+-+ +-+-+
|   |     | | |       | |   |             |   | |   |   |   |   |     |     |         |     | | | |   |     | | |       |
+ +-+ +-+ + + +-+-+ +-+ + +-+-+-+-+-+-+ +-+-+ + + +-+ +-+-+ + +-+-+-+ +-+-+ +-+ +-+-+ +-+ +-+ + + +-+ + +-+ + + +-+ +-+-+
|   |   |   | |   |           |           |   |     |         | | |       | | | | |   |             | |   |   | |   |   |
+ +-+-+-+-+ + + +-+-+-+-+-+-+ +-+-+-+-+-+-+-+ +-+-+ +-+-+-+-+ + + +-+ +-+-+ + + + +-+ + +-+-+-+-+-+ + +-+ +-+ + + +-+-+ +
|   |   |   |           | | |   |   |           |   | | |             | | |   |   |         |           |   | | |     | |
+-+ + +-+-+ + +-+-+-+-+ + + + +-+-+ +-+-+-+-+-+ + +-+ + +-+-+-+ +-+-+ + + +-+-+-+-+-+-+-+-+-+-+-+-+-+-+-+-+-+ + + +-+-+ +
| | |       |   | | |                 | |     | |           | | | |     |     | |         |             | | |   | | |   |
+ + +-+-+ +-+ +-+ + +-+-+-+-+-+ +-+-+ + +-+-+ + +-+-+ +-+-+ + + + +-+ +-+-+ +-+ +-+ +-+-+-+-+-+-+ +-+-+ + + + +-+ + + +-+
| | |     | | |   |     |   |       | |   |       |   | |     |     |     |             |   |   |   |           | |   | |
+ + +-+ +-+ + + +-+-+-+ + +-+-+-+-+ + +-+ +-+-+ +-+-+ + +-+ +-+-+-+-+ +-+ + +-+-+-+-+-+ +-+ +-+ +-+-+-+-+-+-+-+-+ + +-+ +
|                     |             |       |             |         |   |         |                             |       |
+-+-+-+-+-+-+-+-+-+-+-+-+-+-+-+-+-+-+-+-+-+-+-+-+-+-+-+-+-+-+-+-+-+-+-+-+-+-+-+-+-+-+-+-+-+-+-+-+-+-+-+-+-+-+-+-+-+-+-+-+