+-+-+-+-+-+-+-+-+-+-+-+-+-+-+-+-+-+-+-+-+-+-+-+-+-+-+-+-+-+-+-+-+-+-+-+-+-+-+-+-+-+-+-+-+-+-+-+-+-+-+-+-+-+-+-+
| | |     |         |     |         |   | | |                 |       |     | | |       | | | | |   | | | |   |
+ + +-+ +-+-+-+ +-+ +-+-+ + +-+-+-+ +-+ + + +-+-+-+-+-+ +-+-+ + +-+-+-+-+ +-+ + +-+-+-+ + + + + + +-+ + + + +-+
|     | | |   | | |   |   |   | |           |     | |       | |         |     |     |       | | |   |   |   | |
+ +-+ + + +-+ + + + +-+-+ + +-+ +-+-+-+ +-+ +-+ +-+ + +-+-+-+ + +-+-+-+ + +-+ +-+-+ +-+-+ +-+ + +-+ +-+ + +-+ +
|   | |         | | | | |             | | |   |   | |     | | |   | | | |   |       |       |         | | |   |
+ +-+-+-+-+ +-+ + + + + +-+-+-+-+-+-+ + + +-+ + +-+ +-+ +-+ + + +-+ + + +-+ +-+-+-+-+-+ +-+ + +-+ +-+ + + +-+ +
| |   | |     |   | |   | | | | | |   | | | |   |     |     | |   | | | |   |       |     |   |     | |     | |
+ + +-+ +-+-+ +-+-+ +-+ + + + + + +-+-+ + + +-+ + +-+ +-+ +-+ + +-+ + + + +-+-+ +-+ +-+-+-+-+-+-+-+ + +-+ +-+ +
| | | | |   |   |     |   | | |       |   | | |     |   |   |   |     |           | |     |       | |   |   | |
+ + + + + +-+-+ +-+-+ + +-+ + +-+-+-+ + +-+ + + +-+-+-+ +-+-+-+ + +-+ +-+-+ +-+-+-+ +-+ +-+-+-+-+ +-+ +-+-+ + +
|     | |   | | |   | | |       | | | |       | | | | |         |   |   |   | |     |   |   | | | | | |   |   |
+-+ +-+ +-+ + + + +-+ + +-+-+ +-+ + + + +-+-+-+ + + + +-+-+-+-+ + +-+-+-+-+ + +-+ +-+-+ + +-+ + + + + +-+ +-+ +
|           | |     |   |   | |           | |         | | | | |     |   |   |     | |     |     | |   | | | | |
+-+-+-+-+ +-+ +-+-+ +-+ +-+ + + +-+-+-+-+ + + +-+-+-+ + + + + +-+ +-+ +-+-+ +-+-+ + +-+ +-+ +-+ + +-+ + + + + +
| |         |   |   |           |   | |     | | |   | |         |   | |     | |         | |   |     |         |
+ + +-+-+-+ +-+ +-+-+-+-+ +-+-+ + +-+ +-+ +-+ + +-+ + +-+-+-+-+ +-+ + + +-+ + +-+-+-+ +-+ + +-+-+-+ +-+-+ +-+-+
|   |       |   | | |         |         |   |   | | |     | |         | |           |     |   |       |       |
+-+-+ +-+-+ +-+ + + +-+-+-+ +-+-+-+-+-+-+-+-+-+ + + +-+-+ + +-+-+-+-+-+-+ +-+-+-+-+-+-+-+-+-+-+-+-+ +-+-+-+-+ +
|   |     | |   |   | | |           | |   |   |   | | |     |     | | |     | |   | |   |     |     |   | |   |
+ +-+-+-+ + + +-+ +-+ + +-+-+-+-+ +-+ + +-+ +-+-+ + + +-+-+ +-+-+ + + + +-+ + + +-+ +-+ + +-+ +-+ +-+ +-+ +-+ +
|       | |             |           |     | | | |     | | | | |     | | | |       |     | |   | |     |   |   |
+-+-+ +-+-+-+ +-+-+-+-+ +-+-+ +-+-+ + +-+ + + + +-+ +-+ + + + + +-+-+ + + +-+-+-+ +-+-+ + + +-+ + +-+ +-+ + +-+
|     | |   |     | | |           | |   | |               |     |     |   |     |       | |   | |   |   |     |
+ +-+ + + +-+-+ +-+ + +-+-+ +-+-+-+ +-+ + +-+-+-+-+-+-+-+-+-+-+ + +-+ +-+ +-+ +-+ +-+-+ +-+ +-+ +-+ +-+ + +-+-+
| | | |   | |       |     |       | |   |   |   | |   | | |   |     | | |     |       |     |     | |       | |
+ + + +-+ + +-+-+ +-+-+-+ +-+ +-+-+ +-+ +-+ + +-+ +-+ + + + +-+ +-+-+ + +-+-+-+-+-+-+-+ +-+-+ +-+ +-+-+ +-+-+ +
| | |     |     |   |       |   |     | | | | |         |     |     |     | |     |   | |   |   |   |       | |
+ + +-+-+ +-+-+ +-+ +-+-+-+ +-+-+ +-+ + + + + +-+-+-+ +-+ +-+ + +-+-+-+-+ + +-+-+ +-+ + + +-+ +-+-+ +-+-+ +-+ +
|     | |           |         |     | |   | |   | | | | |   | | |       |   |             | |   | |   |   | | |
+-+ +-+ +-+-+-+-+ +-+-+ +-+-+-+-+ +-+ +-+ + +-+ + + + + +-+-+ + +-+ +-+-+-+-+-+ +-+-+-+-+ + + +-+ +-+ +-+ + + +
|       |     | | |   |   |   | | |     | | |         | |                 | |     | |     |   |           | | |
+ +-+-+ +-+ +-+ + + +-+-+ +-+ + +-+-+ +-+-+ +-+ +-+-+ + +-+-+-+-+-+ +-+-+ + +-+-+ + + +-+ +-+ +-+-+-+-+-+ + + +
|     | | | |   |     |               |   |       |               |   |         |   |   |         |   |   |   |
+ +-+-+ + + +-+ +-+-+-+-+-+ +-+-+-+-+ + +-+-+-+-+-+-+ +-+-+-+-+-+ +-+-+-+-+-+-+-+-+ +-+ +-+-+-+-+ +-+ +-+ +-+ +
|     |     | |   |   |     | |   |       |       | | | |   |       |   |   |         | |   | |   | | |   |   |
+-+-+-+-+ +-+ +-+ +-+ +-+ +-+ + +-+-+-+ +-+ +-+-+ + + + + +-+-+-+-+ + +-+ +-+-+ +-+-+-+ +-+ + + +-+ + + +-+-+ +
|         | |   |   | |         |   | | | | | | | | | |   | |       | |       |   | |   |   |   |     |   | | |
+-+-+ +-+ + + +-+ +-+ +-+-+ +-+ +-+ + + + + + + + + + +-+ + +-+-+-+ + +-+-+-+ +-+ + + +-+-+ + +-+ +-+ + +-+ + +
|       |           | |       | |   |   | |   | | | |     |         | |       |   |   | |           | |   | | |
+-+-+-+-+-+-+-+-+-+ + +-+-+-+ + +-+ + +-+ +-+ + + + + +-+-+-+-+-+ +-+ +-+-+ +-+ +-+-+ + +-+ +-+-+-+-+-+-+ + + +
|       |     | |     |   |   |     |     | |   |     | | | | |   |     | |   |   | | | |             | |     |
+-+ +-+ +-+ +-+ + +-+ +-+ +-+-+-+ +-+-+-+ + + +-+-+-+ + + + + +-+ +-+-+ + + +-+-+ + + + +-+-+-+-+ +-+ + + +-+ +
| | |     | |     | |   |   | | | | | | | |       |         | |   |   | | |         |   | |     | | | |   |   |
+ +-+-+ +-+ +-+ +-+ + +-+ +-+ + + + + + + +-+ +-+-+-+-+-+-+-+ +-+ + +-+ + +-+ +-+-+-+-+ + + +-+ + + +-+-+-+ +-+
|       |   |     |   | | |   |       |   |   |   |       |     | |         |         |   |   | |       |     |
+ +-+-+ +-+ +-+-+-+-+ + + + +-+-+ +-+-+-+ +-+ + +-+-+-+ +-+ +-+ + +-+ +-+-+ +-+ +-+-+-+-+ +-+-+ +-+-+-+-+-+-+ +
| | | | |       | | |   |   |     | |   |     |     |       | |     | |             |         |     | |   |   |
+ + + + +-+ +-+ + + +-+ +-+ + +-+ + +-+ +-+ +-+-+ +-+-+-+-+ + +-+-+ +-+-+-+ +-+-+-+ +-+-+-+-+ +-+-+ + + +-+ +-+
| |       |   |       | |   | |   |           |     | | |     | |     | |     |         | |   |     |     |   |
+-+-+-+-+ +-+ +-+-+-+ + + +-+-+-+ +-+-+-+-+-+ +-+-+ + + + +-+ + +-+ +-+ +-+-+-+-+-+-+ +-+ + +-+ +-+ +-+-+ +-+ +
|   |   |   | | |         |   |   | |         |           | | |     |   |         |       |       | | |   |   |
+ +-+-+ + +-+ + +-+-+-+-+ + +-+-+ + +-+ +-+-+-+-+-+-+ +-+ + + +-+-+ +-+ +-+-+ +-+ +-+-+-+-+-+-+-+ + + +-+ +-+ +
|       |     |       |         | | |   |   |       | | |   |     | |           |           |     | |     |   |
+-+ +-+-+-+ +-+ +-+-+ + +-+-+-+-+ + +-+ +-+ +-+ +-+ + + +-+ +-+-+-+ +-+-+-+-+-+-+-+-+-+-+-+ + +-+-+ +-+ +-+-+ +
| | | | | | | |     | | | | |       |   |     | | |   |   | |     | |   |   |   |     |     | |     |   | |   |
+ + + + + + + +-+-+-+ + + + +-+-+-+ +-+ +-+ +-+ + +-+ + +-+ +-+-+ + + +-+ +-+-+ + +-+ + +-+ + +-+-+ + +-+ +-+ +
| |     | |   | |     |   | | |   | |         | | |     | |     |   |   |     |     |     | | | |   |     |   |
+ +-+-+ + + +-+ +-+-+ + +-+ + +-+ +-+-+-+ +-+-+ + +-+-+ + +-+-+-+ +-+ +-+ +-+ +-+-+-+-+ +-+ + + +-+ + +-+ +-+ +
|   |   | |     |     |   |         | |       |     |   |   |         | | |       | |     | |     | |   |   | |
+ +-+ +-+ +-+ +-+ +-+ +-+ +-+ +-+-+ + +-+-+-+-+-+-+-+-+ + +-+-+-+ +-+ + +-+-+-+ +-+ +-+-+-+ +-+-+-+ + +-+-+-+ +
| | | | | |     |   |   | |   |   |   | |     |   |         |       | | |             | |       |       |     |
+ + + + + +-+-+ +-+ +-+ + +-+ + +-+-+ + + +-+ +-+ +-+-+-+ +-+-+-+-+-+ + +-+-+-+-+-+-+ + +-+-+-+ +-+ +-+-+-+-+-+
| | |         |   |   | |   | |       |     | |         |   |           |       |   | | |   | | |         | | |
+ + +-+-+-+-+ +-+ +-+-+ + +-+-+-+ +-+ +-+ +-+ +-+-+ +-+ +-+-+-+-+ +-+-+ +-+ +-+ + +-+ + + +-+ + +-+-+ +-+ + + +
|   |   |         | |       |       |       |   | |   | |   | |       |     |     |   |     | |   |     |     |
+-+ + +-+-+-+-+-+ + +-+-+-+ +-+-+-+-+-+ +-+-+-+ + +-+ + + +-+ +-+ +-+-+-+-+-+-+-+ +-+ + +-+ + +-+ +-+-+-+-+-+ +
|     |               |   | |       |   |       |   | |   | |         |     |           |   | |   |       |   |
+-+-+ +-+-+ +-+-+-+-+ +-+ + +-+-+ +-+-+ +-+-+-+ +-+ +-+-+ + +-+-+-+ +-+-+ +-+-+-+ +-+-+-+-+ + + +-+ +-+-+ +-+ +
|                   | |                       |                 |               |         |             |   | |
+-+-+-+-+-+-+-+-+-+-+-+-+-+-+-+-+-+-+-+-+-+-+-+-+-+-+-+-+-+-+-+-+-+-+-+-+-+-+-+-+-+-+-+-+-+-+-+-+-+-+-+-+-+-+-+