+-+-+-+-+-+-+-+-+-+-+-+-+-+-+-+
|   | | |     | |     |     | |
+ +-+ + + +-+-+ + +-+ + +-+-+ +
|   |       |     | |         |
+ +-+-+-+ +-+ +-+ + + +-+-+-+-+
|               | |       |   |
+-+-+-+-+-+-+-+-+-+-+-+ +-+-+ +
| |     |     | | |           |
+ + +-+ +-+-+ + + +-+-+ +-+-+-+
|   |   |   |     | |       | |
+-+-+-+ +-+ + +-+ + +-+-+ +-+ +
| |   | |     | |   |     | | |
+ + +-+ +-+-+ + + +-+ +-+ + + +
|   |       |   | | |   | |   |
+ +-+ +-+-+ +-+-+ + +-+-+ + +-+
|     |         |         | | |
+-+-+-+-+-+-+ +-+-+-+-+-+ + + +
| |   |   | | |             | |
+ + +-+ +-+ + +-+ +-+-+-+-+-+ +
|     | | | |   | |   | |     |
+-+ +-+ + + +-+ + + +-+ + +-+-+
|       | |     | |   |       |
+ +-+-+ + +-+ +-+ + +-+-+-+-+ +
| |   |     |   |     | | |   |
+ + +-+ +-+ +-+ +-+-+ + + +-+ +
| |   | |   | | |   | | |     |
+ + +-+-+ +-+ + + +-+ + +-+-+ +
| |       |     |             |
+ +-+-+-+ +-+ +-+-+ +-+-+-+-+-+
| |       |     | |       |   |
+-+ +-+-+ + +-+ + +-+ +-+ +-+ +
|       |     |   | |   |     |
+-+-+-+ +-+-+-+-+ + + +-+-+-+-+
| |       | |     | |   |   | |
+ +-+-+-+ + + +-+-+ + +-+ +-+ +
|           |       |     |   |
+-+ +-+-+-+ +-+-+-+ + +-+-+-+ +
|         |     |       |     |
+-+-+-+-+-+-+-+-+-+-+-+ + +-+-+
| |       | |     |   |     | |
+ +-+-+-+ + +-+-+ + +-+-+ +-+ +
|     |   | |         |   |   |
+-+ +-+-+ + +-+ +-+-+ + +-+-+ +
|   |   |           |   | |   |
+ +-+ +-+-+-+-+-+-+-+ +-+ + +-+
|     | |             | |     |
+-+-+ + +-+-+-+-+-+-+ + + +-+-+
|   | |   |     |   |   |     |
+-+ + + +-+-+-+ + +-+ +-+ +-+-+
| | |   | |       | |   | | | |
+ + + +-+ + +-+-+ + + +-+ + + +
|         |     | |     | |   |
+-+-+ +-+ + +-+-+ + +-+ + + +-+
| |   | |     |   | | |     | |
+ +-+ + +-+-+-+ +-+ + + +-+-+ +
| |   |   |   |       |       |
+ + +-+ +-+ +-+-+-+-+-+ +-+-+-+
| | |   | |               |   |
+ + +-+ + +-+-+-+-+-+ +-+ +-+ +
|         |             |     |
+-+-+-+-+-+-+-+-+-+-+-+-+-+-+-+