+-+-+-+-+-+-+-+-+-+-+-+-+-+-+-+
|   |   | |   |   | | |     | |
+-+ +-+ + +-+ +-+ + + + +-+-+ +
|       |     |   |           |
+-+ +-+ +-+-+ +-+ + +-+-+-+-+-+
|     |         |         | | |
+-+-+-+ +-+-+-+ +-+-+-+-+ + + +
|   |   | | |       | |       |
+-+ + +-+ + +-+-+-+ + +-+-+ +-+
|   |       |           |     |
+-+ +-+-+-+-+-+-+-+-+ +-+-+ +-+
| |   |   | |   |       |   | |
+ + +-+-+ + +-+ +-+-+-+ +-+ + +
|     |       |   |     | |   |
+ +-+ +-+ +-+ + +-+-+-+ + +-+ +
|   |       |     |   | | | | |
+-+-+-+ +-+-+-+-+ +-+ + + + + +
|           | |   |   |       |
+-+-+ +-+-+ + +-+ + +-+-+ +-+-+
| |       |     | |   |   | | |
+ +-+-+-+ +-+-+-+ + +-+-+ + + +
| |   | |   |   |           | |
+ + +-+ + +-+-+ +-+ +-+-+-+-+ +
|   | | |         |       |   |
+-+ + + +-+-+-+ +-+-+-+-+ +-+ +
| |     |   |       |       | |
+ + +-+ + +-+-+-+-+-+-+-+ +-+ +
|   |     |   | |   |   |     |
+-+-+-+-+ + +-+ +-+ + +-+-+-+ +
|                             |
+-+-+-+-+-+-+-+-+-+-+-+-+-+-+-+