+-+-+-+-+-+-+-+-+-+-+-+-+-+-+-+-+-+-+-+-+-+-+-+-+-+-+-+-+-+-+-+-+-+-+-+
| | | | | |   |       |   |       | | | |   | |   |   |   |   |       |
+ + + + + + +-+-+-+-+ + +-+-+-+ +-+ + + + +-+ + +-+-+ + +-+-+ + +-+-+-+
|       |   |     |         | | | |         | | |     |     |         |
+ +-+ +-+ +-+-+ +-+-+-+ +-+ + + + +-+ +-+-+ + + + +-+-+-+ +-+ +-+-+-+-+
|   | |       |   | |   |     | |   |   | |           |     | | |   | |
+ +-+ +-+-+-+ +-+ + +-+-+ +-+ + + +-+-+ + +-+ +-+-+-+ +-+-+ + + +-+ + +
|   | |           |   |   |       |     | | |       | |       |   | | |
+-+ + +-+-+-+ +-+ +-+ +-+-+ +-+ +-+ +-+ + + +-+-+ +-+ +-+-+ +-+ +-+ + +
|   | |       |     | | |     | | | | |   |         |   | |   |   | | |
+ +-+-+-+-+ +-+-+-+ + + + +-+ + + + + +-+-+ +-+-+-+-+-+ + + +-+ +-+ + +
|               | |   |   |   | |   | |   |           | | |       |   |
+ +-+-+-+-+-+-+ + +-+ +-+ +-+-+ + +-+ + +-+-+-+ +-+ +-+ + +-+-+ +-+ +-+
| |     |         |         |     |       |     |     | |   |     | | |
+ +-+-+ +-+-+-+-+-+-+-+-+-+-+ +-+ + +-+-+ +-+-+-+-+-+-+ +-+ +-+-+ + + +
| |         | | |       |       |   |             | | | |         |   |
+ +-+-+-+-+ + + + +-+-+-+-+-+-+-+-+-+-+-+-+-+ +-+ + + + +-+-+-+ +-+-+ +
|       | | |   |   | |     | |       |       | |     |   | | |   | | |
+ +-+-+ + + +-+ +-+ + + +-+ + +-+-+-+ +-+-+ +-+ + +-+-+-+ + + + +-+ + +
| |         |   | | |     |   | |         | |       | |           |   |
+-+-+ +-+-+ + +-+ + +-+-+-+-+ + +-+-+-+-+ +-+-+-+ +-+ +-+-+-+-+ +-+ +-+
|     |         | |             | |   |   | | | |     | |     | |     |
+-+-+-+-+-+-+-+ + +-+-+-+-+-+ +-+ + +-+-+ + + + + +-+ + +-+ +-+ + +-+-+
|     |               | | | |   |     |       |     |       |         |
+-+ +-+-+-+-+-+ +-+-+ + + + +-+ +-+ +-+-+ +-+ +-+-+-+-+ +-+-+-+-+-+-+-+
|   |   | |     |   | | |   | |       |   |                 |         |
+-+ + +-+ +-+-+ +-+ + + + +-+ + +-+-+ + +-+-+-+-+-+-+-+-+-+ + +-+-+-+-+
| |   | |     |     | |   | |     |   |       | |   | |       |   |   |
+ + +-+ + +-+ +-+ +-+ + +-+ + +-+-+-+-+ +-+-+ + + +-+ + +-+-+ + +-+-+ +
|   | | |   |   | |   |   |   |     | |   |     | | | |   |   |   | | |
+-+ + + +-+ +-+ +-+ +-+ +-+ +-+ +-+ + +-+-+-+ +-+ + + + +-+-+-+-+ + + +
|   | |     |   |     |     |     |       |   |   |     |     |       |
+-+ + +-+-+-+-+ + +-+ +-+ +-+-+-+-+ +-+-+ +-+ +-+ + +-+ + +-+ +-+-+ +-+
|   |     | |     | | |     |       |       | | | |   |     |   |     |
+-+ +-+-+ + + +-+ + + +-+ +-+-+-+-+ +-+-+-+ + + + +-+-+-+ +-+-+-+-+ +-+
| |   | |     |   |     |     |           |   |       | |       | | | |
+ + +-+ +-+-+-+-+ +-+-+-+-+ +-+-+ +-+-+-+-+-+ +-+-+ +-+ +-+-+ +-+ + + +
|     |           |         | |   |     | |       |       |       |   |
+-+ +-+-+ +-+-+ +-+-+-+-+-+ + +-+ +-+ +-+ +-+ +-+ +-+ +-+ +-+ +-+ + +-+
|     | |     | |                   | |   |   |     | | |   |   |   | |
+-+ +-+ +-+ +-+-+-+-+ +-+-+-+-+-+-+ + +-+ +-+ +-+-+ + + + +-+-+ +-+-+ +
|   | | |   |     |   |         | | | |   |   | |     |     | |   |   |
+ +-+ + +-+ +-+-+ +-+ +-+-+-+ +-+ + + +-+ + +-+ +-+-+ +-+-+ + +-+ +-+ +
|   |   | |       |           |   |   | | | |   |         | |   | |   |
+ +-+ +-+ +-+ +-+-+-+-+-+-+-+ +-+ + +-+ + + + +-+ +-+-+-+-+ +-+ + +-+ +
| | |     | |     |       |       |     |       | |     | | | | |   | |
+ + +-+ +-+ +-+ +-+ +-+-+ +-+-+-+-+-+-+-+-+ +-+-+ +-+ +-+ + + + + +-+ +
| | | | | | |       | |               |     |   |   | | |     |     | |
+ + + + + + +-+-+ +-+ +-+-+-+-+ +-+-+-+-+-+-+ +-+ +-+ + +-+-+ +-+-+-+ +
| |     |   |   |       |             | |                 | |         |
+ +-+ +-+-+ +-+ + +-+-+-+-+-+-+-+-+-+ + +-+-+-+-+-+ +-+-+ + + +-+ +-+-+
|         | |   |   |   |   | |   |   |   |             | |     | |   |
+-+-+ +-+ + +-+ +-+ + +-+-+ + +-+ + +-+-+ +-+-+-+-+-+-+-+-+ +-+-+ + +-+
|       | | |           | | | |   |   | |       |     |         |     |
+-+ +-+-+ + + +-+-+-+-+ + + + + +-+-+ + +-+ +-+ +-+-+ +-+-+-+-+-+ +-+-+
| |   | | | | |   | |     | | | |   |       | |       | |     |   | | |
+ +-+ + + + + +-+ + +-+-+ + + + +-+ + +-+-+ + + +-+-+ + + +-+ +-+ + + +
| |     |   |     |       | |       |     | |       |   |   |         |
+ +-+-+-+ +-+ +-+-+-+-+-+ + +-+-+ +-+-+-+ +-+-+-+-+-+-+-+-+-+-+-+-+-+ +
| |   |     |   |       | | | |   | | |       |     |     |   |   |   |
+ +-+ +-+-+ +-+ + +-+-+ + + + + +-+ + + +-+ +-+ +-+ +-+ +-+-+ +-+ +-+ +
|     |         |   |   |     |         | |   |   |   | | | |   | |   |
+-+ +-+-+-+ +-+ +-+-+ +-+-+-+-+-+-+ +-+ + + +-+-+-+ +-+ + + + +-+ + +-+
|     |     |     |   | | |   | | |   |   |   |   | | |   | |   |   | |
+-+ +-+-+-+ +-+-+ + +-+ + + +-+ + + +-+-+-+-+ + +-+ + + +-+ +-+ +-+ + +
|   |   |       | |       | |   |   |   |                 |       | | |
+-+ + +-+-+-+-+ + +-+-+-+ + + +-+-+ + +-+-+-+ +-+-+-+-+-+-+-+ +-+ + + +
|       |     | | |         |       |   |   |   |   |     | | |       |
+-+ +-+ +-+-+ + +-+ +-+-+-+ +-+-+ +-+-+ + +-+ +-+-+ + +-+ + +-+-+ +-+-+
|   |   |   | |     | |         |           |       |   |       | |   |
+-+-+-+ +-+ + +-+ +-+ +-+ +-+-+-+-+ +-+-+-+-+-+-+-+ +-+-+-+-+ +-+ + +-+
| |     |   |           |   |   |           | |         | |           |
+ +-+-+ +-+ + +-+-+-+-+-+-+ +-+ + +-+-+-+-+ + +-+ +-+-+ + +-+-+-+ +-+-+
|     |   |     |   | | |       |   | | |       | |       |   | | | | |
+ +-+ + +-+-+ +-+ +-+ + +-+-+-+-+ +-+ + +-+-+-+-+-+-+-+-+ + +-+ + + + +
|   |       |       |         |     | | | |       | |   | |     |     |
+-+ +-+-+-+ + +-+-+ +-+-+-+-+ +-+ +-+ + + +-+-+-+ + + +-+ + +-+ +-+-+ +
|   |   | |       |       | | | |           | |         | | | |   |   |
+ +-+ +-+ +-+-+-+-+ +-+-+ + + + +-+-+-+ +-+ + +-+ +-+-+ + + + + +-+ +-+
|         |   | | |   |         |   |     |     |     | |   |     |   |
+-+-+ +-+ + +-+ + +-+ +-+-+-+-+ +-+ +-+-+ +-+-+ +-+ +-+ +-+-+-+ +-+-+-+
| |     |           |   |   |   | |     | |   | | |   |   | |   |   | |
+ +-+-+-+ +-+-+-+-+-+-+ + +-+ +-+ + +-+ + +-+ + + +-+ +-+ + +-+ + +-+ +
| |             | |       |       |   |       |         |   |   |     |
+ + +-+-+-+-+-+ + +-+-+-+-+-+-+ +-+-+-+-+-+-+-+ +-+-+-+-+-+-+-+-+-+-+ +
|   |     |     | |         | |   |       | |     |   |     |         |
+ +-+-+ +-+ +-+ + + +-+-+-+ + + +-+-+ +-+ + +-+-+ +-+ +-+ +-+ +-+-+-+-+
| | |     | |           | |   | |   |   |                 | | | |     |
+ + +-+-+ +-+-+-+-+ +-+ + +-+-+ + +-+-+-+-+-+-+-+-+ +-+-+ + + + +-+-+ +
|             |       |   |                     |       |             |
+-+-+-+-+-+-+-+-+-+-+-+-+-+-+-+-+-+-+-+-+-+-+-+-+-+-+-+-+-+-+-+-+-+-+-+