+-+-+-+-+-+-+-+-+-+-+-+-+-+-+-+-+-+-+-+-+-+-+-+-+-+
|       | |     | | |   | | |     | | | | |       |
+-+ +-+ + + +-+ + + + +-+ + +-+ +-+ + + + + +-+-+-+
|     | |   |       |   | | | |     |   |   | | | |
+-+-+-+ +-+ +-+-+-+ +-+ + + + + +-+ + +-+-+ + + + +
|             |   |       | |   | |     |   |   | |
+-+-+-+-+-+ +-+ +-+-+-+-+ + + +-+ +-+ +-+ +-+-+ + +
| |   |               |   | |     |   |   |   | | |
+ +-+ +-+-+-+-+-+ +-+-+-+ + +-+-+ +-+ +-+ + +-+ + +
|         |   |       | | |   | |   | | |   |     |
+-+-+-+-+ + +-+-+-+-+ + + + +-+ +-+-+ + + +-+-+-+ +
|   |     |   |   | |   |       | |   |   | |   | |
+ +-+-+ +-+-+ +-+ + + +-+-+-+-+ + + +-+ +-+ + +-+ +
| | | |       | |     | | | |   | | |       |     |
+ + + +-+-+-+ + +-+-+ + + + +-+ + + +-+ +-+ +-+ +-+
| | |         | | |   | | |   |         | |       |
+ + +-+-+ +-+ + + + +-+ + + +-+-+-+ +-+ + +-+-+-+ +
| |   | |   |   |   |               |   | | | |   |
+ + +-+ +-+-+-+ +-+-+-+-+-+-+-+ +-+-+-+ + + + +-+ +
| |   | |   | | | |         |   | |         |   | |
+ + +-+ +-+ + + + +-+-+ +-+ + +-+ + +-+-+-+ + +-+ +
| |       |   |     |   |         |   |   |     | |
+ +-+-+ +-+ +-+-+ +-+-+-+-+-+-+-+-+ +-+ +-+-+-+ +-+
|             |           |           | |         |
+-+-+-+-+-+ +-+-+ +-+-+-+ + +-+-+-+-+ + +-+-+ +-+-+
|         |   | |       |     |       |       |   |
+-+ +-+-+ +-+ + +-+-+-+-+-+-+-+ +-+-+-+-+-+-+ + +-+
|     | | |   | |   | | |         |     |   |     |
+ +-+ + + + +-+ + +-+ + +-+-+-+-+ +-+-+ + +-+ +-+-+
|   |   |                               |         |
+-+-+-+-+-+-+-+-+-+-+-+-+-+-+-+-+-+-+-+-+-+-+-+-+-+