+-+-+-+-+-+-+-+-+-+-+-+-+-+-+-+-+-+-+-+-+-+-+-+-+-+
| | | |   |   |       | |   | |   | |   | |       |
+ + + + +-+ +-+-+-+ +-+ +-+ + + +-+ + +-+ + +-+-+-+
| | |         |       | |   | |       |     |   | |
+ + +-+ +-+-+ +-+-+-+ + + +-+ +-+-+ +-+ +-+ + +-+ +
|   |       |   |   |   | |     |   | | |         |
+-+ + +-+-+-+-+ + +-+-+ + + +-+ +-+ + +-+-+-+ +-+-+
|   |   |   |   | |         |       | |   |   |   |
+-+ + +-+ +-+ +-+ +-+-+ +-+-+-+-+-+ + + +-+-+ + +-+
|   |       | |   |         | |       | | |       |
+ +-+-+-+-+ + + +-+-+-+-+ +-+ +-+-+-+ + + + +-+-+-+
|     |     |           | | |     |     | | |   | |
+-+ +-+-+-+-+-+-+-+-+-+ + + + +-+ +-+-+ + + +-+ + +
|                 |         |   |               | |
+-+-+ +-+-+-+-+-+ +-+-+-+-+ +-+-+-+-+-+-+-+-+-+-+ +
|   |         | |       | | | | | |   |         | |
+-+ +-+-+-+ +-+ +-+ +-+ + + + + + +-+ +-+-+-+-+ + +
| |     |       | | |     |     | | |             |
+ + +-+ + +-+-+ + + +-+-+ +-+-+ + + +-+ +-+-+-+-+-+
|   |         |   |     | |   | |           |     |
+-+ +-+-+-+-+ +-+-+-+-+-+ +-+ + + +-+-+-+ +-+-+-+ +
|         |   |     |   |       | |           |   |
+-+-+ +-+-+-+ + +-+ +-+ +-+ +-+ +-+-+-+-+-+ +-+ +-+
|       |     | | |       | | |     | |   | |   | |
+-+ +-+-+-+-+ + + +-+-+-+ + + + +-+ + + +-+ +-+ + +
| |     |   | |         |     | |     |         | |
+ +-+ +-+ +-+-+-+-+-+ +-+-+-+-+-+-+-+ + +-+-+-+-+ +
|   | |   |     |   |     |   | |     | |   |     |
+ +-+ +-+ +-+-+ +-+ +-+ +-+ +-+ +-+-+ + +-+ + +-+-+
|   |     |         |   |   |       | |           |
+-+ +-+-+ +-+-+-+-+ + +-+-+ + +-+-+ + +-+-+ +-+-+-+
| |     |   |   | |             |   | |     | | | |
+ +-+-+ +-+ + +-+ +-+-+-+-+-+ +-+-+-+ +-+ +-+ + + +
|                 | | |   |   |   |           |   |
+-+-+-+-+-+-+-+ +-+ + + +-+ +-+ +-+-+-+-+-+ +-+ +-+
|   | |   |   |     |             |           | | |
+-+ + + +-+-+ +-+-+-+-+-+-+-+-+-+-+-+-+-+-+ +-+ + +
|     |   |   | |   | | | |     |             |   |
+-+ +-+-+ + +-+ + +-+ + + +-+-+ +-+-+-+-+-+-+ + +-+
|   | | |     |   | |       | | |   |     | |     |
+-+ + + +-+-+ + +-+ +-+-+ +-+ + +-+ +-+-+ + + +-+-+
| | |       | |   |   | |       | |   |   |     | |
+ + + +-+-+ + +-+ +-+ + +-+ +-+ + + +-+-+ +-+-+ + +
| |   |     |   |             |       | |   |     |
+ +-+-+ +-+ +-+ +-+-+-+-+-+-+-+-+-+-+ + +-+ + +-+-+
|   | |   |         | | |   | | |   |             |
+ +-+ +-+-+ +-+-+-+ + + +-+ + + + +-+-+-+-+ +-+-+-+
| | |   |   | | |     |     | | | |   |   | |     |
+ + +-+ + +-+ + + +-+ + +-+ + + + + +-+-+ + +-+-+ +
|             |   |       |                       |
+-+-+-+-+-+-+-+-+-+-+-+-+-+-+-+-+-+-+-+-+-+-+-+-+-+