+-+-+-+-+-+-+-+-+-+-+-+-+-+-+-+-+-+-+-+-+-+-+-+-+-+-+-+-+-+-+-+-+-+-+-+-+-+-+-+-+-+-+-+-+-+-+-+-+-+-+
|   | | |     |   | |         |   |         |   |             | |           |   |                 | |
+ +-+ + + +-+ +-+ + + +-+-+-+ +-+ +-+-+-+-+ + +-+-+ +-+ +-+-+ + +-+-+-+-+-+ +-+ +-+-+-+-+-+ +-+-+ + +
|         |       |   | |   |       | |       |   | |   |   |   |     |   |         | |     |   | | |
+-+-+ +-+-+-+-+-+ +-+ + + +-+ +-+-+ + +-+-+ +-+-+ + + +-+ +-+ +-+-+-+ +-+ +-+ +-+-+ + +-+ +-+-+ + + +
|         | |     |         |   |     |   | | |     |   |             |       |   |     |     |     |
+-+ +-+-+ + +-+-+ +-+-+-+ +-+-+-+-+-+ +-+ + + +-+ +-+-+-+-+-+-+-+-+-+ +-+ +-+ +-+ + +-+ +-+-+ +-+-+-+
| | | |     |     |   |     | |     |   |         |     |       |     | |   |   |     | | |     | | |
+ + + +-+-+ +-+-+ + +-+-+ +-+ +-+-+ + +-+ +-+-+-+ +-+-+ +-+-+ +-+ +-+ + +-+-+-+-+-+-+-+ + +-+ +-+ + +
|     | |     | |         | | | |       |   |     | | |         |   |         |   |   |           | |
+-+ +-+ +-+ +-+ +-+-+-+ +-+ + + +-+-+-+ + +-+-+-+ + + +-+-+ +-+ +-+-+ +-+-+-+ + +-+ +-+-+ +-+-+-+-+ +
|     |   |       |                   | |       |   | |     |         | | |         |     | | |     |
+-+ +-+ +-+ +-+-+-+-+-+-+-+-+-+-+-+-+-+-+ +-+-+-+-+ + +-+ +-+-+-+-+-+ + + +-+-+-+-+ +-+ +-+ + + +-+-+
| | | |       |         | | | | |   |         | | |     |   |       |       | |   | |   | |   | |   |
+ + + + +-+-+ +-+ +-+-+ + + + + +-+ + +-+-+-+ + + +-+-+-+ +-+-+-+ +-+-+-+ +-+ + +-+ +-+ + + +-+ + +-+
| | |   |   |     |   |   | | |   |   |         |   |   |     |     |   | | | |   |         | | | | |
+ + +-+ + +-+-+-+ +-+ +-+ + + + +-+-+-+-+-+-+ +-+-+ + +-+-+-+ +-+-+ + +-+ + + + +-+-+-+ +-+ + + + + +
|     |       |     |   |         | | |     | | |   | |   |         |   |     |     | | |   | | | | |
+ +-+-+-+-+-+-+-+-+ + +-+ +-+-+-+ + + +-+ +-+ + + +-+ +-+ +-+-+-+-+ + +-+-+ +-+-+-+ + +-+ +-+ + + + +
|       |           | | | | | |   |   | | |         |     | | |   |     |   |         | |   |     | |
+-+-+-+-+-+-+-+-+-+ + + + + + +-+ +-+ + + +-+-+-+-+ +-+-+ + + + +-+-+-+ +-+ +-+ +-+-+ + + +-+-+-+ + +
|   |   |   |         | | |   | |     |           | | |                 | | |   | |     |   | |   | |
+ +-+-+ +-+ +-+-+-+ +-+ + +-+ + +-+ +-+-+-+-+-+-+ + + +-+-+-+-+-+ +-+-+ + + +-+ + +-+ +-+ +-+ + +-+ +
| |   | |     |   |     | |   |     | | |   |   |   |       |         | | | | | |   |   |   |   | | |
+ + +-+ +-+-+ + +-+-+-+-+ +-+ +-+-+ + + + +-+ +-+ +-+-+ +-+-+ +-+-+-+-+ + + + + + +-+ +-+-+ + +-+ + +
|       |   | |         | | |   | |       |     | |       | |   | |   |   | | |     | |     |       |
+-+-+-+ + +-+ + +-+-+-+ + + +-+ + +-+ +-+ +-+ +-+ + +-+-+ + +-+ + +-+ +-+-+ + + +-+-+ +-+-+ +-+-+ +-+
| |   |         |                   | |       | |   | |       |   |   |   | | |   |   |     |       |
+ +-+ +-+-+-+-+ +-+-+-+-+-+-+-+-+-+-+-+-+-+-+ + +-+ + +-+-+ +-+-+ + +-+ +-+ + +-+-+ +-+-+ +-+-+ +-+-+
| | |       | | |   | | | |         |                 | |   |           | | | |               |   | |
+ + +-+ +-+ + + +-+ + + + +-+ +-+-+-+-+-+-+-+-+-+-+ +-+ +-+ +-+-+-+-+-+ + + + +-+-+-+ +-+-+-+ +-+ + +
|   |   | | |     | |   |         |         |           |         | | |   | |         | | | | | |   |
+ +-+-+ + + +-+ +-+ +-+ +-+-+ +-+ +-+-+-+-+ +-+-+-+-+-+-+-+-+-+ +-+ + + +-+-+-+-+-+-+ + + + + + + +-+
|         |   |   |   |   |   | | |         | |                 |   |       | |           |   |   | |
+ +-+-+-+-+ +-+-+ +-+ + +-+-+ + + + +-+-+-+-+ +-+ +-+-+-+-+-+-+ + +-+-+-+ +-+ +-+-+-+ +-+-+-+ +-+ + +
| | |     | |   |         |   |     | |     |   |     | | | |   | | | |   |   | | |         | |     |
+ + +-+-+ + + +-+ +-+-+-+ +-+-+-+-+ + +-+-+ +-+ + +-+ + + + + +-+ + + +-+ + +-+ + +-+-+-+ +-+ + +-+-+
|   | |     |   | |                   | |         |         |   | | | |   | |           | | |   | | |
+-+ + + +-+ + +-+-+-+-+-+ +-+-+-+-+-+ + + +-+ +-+-+-+-+-+ +-+-+ + + + +-+ + +-+-+-+-+-+ + + +-+ + + +
|     |   |     | |         | | |     | |   | |     | | | | |   |     |     | |     |       |   | | |
+-+ +-+-+-+-+-+ + +-+-+-+ +-+ + + +-+ + + +-+ +-+ +-+ + + + + +-+-+-+ +-+-+ + +-+ +-+-+-+-+-+ +-+ + +
|     |     |     |       |         |   |   | | |   |   | |   | |           | | |   | | |   | | | | |
+-+ +-+-+ +-+-+ +-+-+ +-+-+-+-+-+-+-+-+-+-+-+ + + +-+ +-+-+-+ + +-+-+-+-+ +-+ + +-+ + + +-+ + + + + +
|   |   | | |         |     | |   | |           |   |       |     | |                       | | | | |
+-+ + +-+ + +-+ +-+-+ + +-+ + +-+ + +-+-+-+-+-+ + +-+ +-+-+-+-+-+ + +-+-+-+ +-+-+-+-+-+-+-+-+-+ + + +
| |     | |       | |   |         | |         |     | | |     | | |           |   |           | |   |
+ +-+ +-+ +-+ +-+ + +-+-+-+-+-+ +-+ +-+-+-+ +-+-+ +-+ + +-+ +-+ +-+-+-+-+ +-+-+ +-+-+-+-+-+-+ + +-+ +
| |     |     | |   | | | |               | |   |   |               |     |   | |   |         | | | |
+ +-+-+-+-+-+ + +-+ + + + +-+-+-+-+-+ +-+ + +-+ +-+ +-+-+-+-+-+-+ +-+-+-+ +-+ + +-+ +-+-+ +-+ + + + +
| |           |   |   | |           |   |     | | |   |   | |   |             | |     |   | |   |   |
+ +-+-+-+ +-+ +-+ + +-+ +-+-+-+ +-+ +-+-+-+-+ + + +-+ + +-+ +-+ +-+-+ +-+-+-+ + +-+-+ +-+ + + +-+-+ +
|     |     |     |       | | | |   | | |   |       | |       |           | | | |     |   |     |   |
+ +-+ +-+-+ +-+ +-+-+-+-+ + + + +-+ + + +-+ +-+-+-+ + +-+-+ +-+ +-+-+-+-+ + + + +-+-+ +-+ +-+-+-+-+ +
|   |     |   |         | | |     |             |   |     | | |     | | | |       |     |     |   | |
+-+-+ +-+ +-+-+-+-+-+-+-+ + +-+-+-+-+-+-+-+-+ +-+-+ +-+-+ + + +-+ +-+ + +-+-+-+ +-+-+ +-+-+-+ + +-+ +
| |     | |   | | | | | |     |       |   |           |         | |   |         |   |     |         |
+ +-+-+-+ +-+ + + + + + +-+ +-+-+ +-+ +-+ +-+-+-+-+-+-+-+ +-+-+-+ + +-+-+-+ +-+ + +-+-+-+ + +-+-+-+-+
|     |     | |     |   | | | | | |   | | | | |     |     | |       |         |   | |   | | |   |   |
+ +-+ +-+-+ + + +-+ + +-+ + + + +-+ +-+ + + + + +-+ +-+-+ + +-+ +-+-+-+-+-+-+-+-+ + +-+ + + + +-+ +-+
| |             |           |   |   | |   |   | | |           | | |         |       | | |   |       |
+-+-+-+-+ +-+-+-+-+-+-+-+-+ + +-+ +-+ + +-+-+ + + +-+-+-+-+-+ + + + +-+ +-+ +-+ +-+ + + +-+ +-+ +-+-+
| |   |     | |       |   | |     | |         | | |   |   |   | | |   |   |     |       |       | | |
+ + +-+-+-+ + + +-+-+ + +-+ +-+-+ + +-+ +-+-+ + + + +-+ +-+ +-+ + +-+ +-+-+-+ +-+-+-+-+ +-+ +-+ + + +
| | |   |     | |       | | | |     |       | |   |     | | |   | | | |   | |       | | | | |       |
+ + + +-+-+-+ + +-+-+-+ + + + +-+-+ +-+-+-+-+ +-+ +-+-+ + + +-+ + + + + +-+ + +-+-+ + + + +-+-+ +-+-+
|     |       |       |   |   |   |   |       | |   | |       | |     | |         | |     |   | | | |
+-+-+ +-+-+-+ +-+ +-+-+-+ +-+ + +-+-+ +-+-+ +-+ +-+ + +-+-+ +-+-+-+-+ + +-+-+ +-+-+-+-+-+-+-+ + + + +
|         |       |         | | |                   |         | | |   | |   |   | | | |       | | | |
+-+ +-+-+-+-+-+-+-+-+-+ +-+-+ + +-+-+-+-+ +-+-+-+-+-+-+-+-+-+ + + +-+ + + +-+-+ + + + + +-+-+ + + + +
| |   |       |     |   |               | |   |   |                 |       |   | | | |     | | |   |
+ +-+ +-+-+-+ + +-+ +-+-+-+-+-+-+-+-+-+ + + +-+ +-+-+-+-+-+-+-+-+-+-+-+-+-+-+-+ + + + +-+ +-+ + +-+ +
|       | |       |         |     |   | | |   |   |   |       |   |     | |     |           |   | | |
+-+ +-+ + + +-+-+-+-+-+-+-+ +-+ +-+-+ + + + +-+ +-+-+ +-+ +-+ +-+ +-+ +-+ +-+ +-+-+ +-+-+-+-+ +-+ + +
| | | | | |               |   | |     | |     | |       |   |     |         |           | |   |   | |
+ + + + + +-+-+-+-+-+-+-+-+ +-+ +-+ +-+ +-+-+ + +-+-+-+ +-+-+ +-+ +-+-+ +-+ +-+-+-+-+ +-+ +-+ + +-+ +
|     | |       | |           | | |   | | |       |   | |   | |       |   | | | |   |     | |     | |
+-+ +-+ + +-+-+ + +-+ +-+-+-+ + + + +-+ + +-+ +-+ +-+ + + +-+-+-+-+ +-+-+ + + + +-+ +-+-+ + +-+-+ + +
|     |       |     |       |   | | |   |       |     | |   | |         | | | |     |   | |   |     |
+-+-+-+-+ +-+-+-+-+ +-+-+-+ +-+ + + +-+-+ +-+-+-+-+-+ + + +-+ + +-+-+-+ +-+ + + +-+ + +-+ + +-+-+ +-+
|   | |     |   | |           | |   | | | |   | | |           | |   |             |     |       |   |
+ +-+ +-+ +-+ +-+ +-+-+-+ +-+-+ + +-+ + + + +-+ + +-+-+-+-+-+ + +-+ +-+-+-+-+-+ +-+-+-+ +-+ +-+-+-+-+
|   |   |   | |     | |   |     |             | |     |   |   | |   |       |         | |   | | |   |
+-+ +-+ + +-+ +-+ +-+ +-+-+-+ +-+-+-+-+-+-+ +-+ +-+ +-+-+ + +-+ + +-+ +-+-+ +-+-+ +-+-+ +-+ + + +-+ +
|     | |   |   |     | | | | |           | | |             | | |   |     |   |   |   |             |
+-+-+ + +-+ + +-+-+ +-+ + + + +-+ +-+-+-+ + + +-+-+-+-+-+ +-+ + +-+ +-+ +-+-+ + +-+-+ +-+ +-+-+-+-+-+
|   |   |         |                   | | |     | | |     |       |   |   |   |   | | |           | |
+ +-+-+ +-+ +-+-+-+-+-+-+-+-+-+-+-+-+ + + +-+-+ + + +-+-+-+ +-+-+ +-+ +-+-+-+ +-+ + + +-+-+-+-+ +-+ +
|         |   |                   |     |       | |       | |       |   |       |   | | | | |   | | |
+-+-+-+ +-+ +-+-+-+-+ +-+-+-+-+-+ +-+-+-+-+-+ +-+ + +-+-+ +-+-+ +-+ + +-+-+-+ +-+ +-+ + + + + +-+ + +
| |         |   | | |           |   |   |     |     |   | | |   |       |   | |             |   |   |
+ +-+-+-+ +-+-+ + + +-+-+-+-+-+-+-+ + +-+-+-+ +-+ +-+-+ + + + +-+-+-+-+ +-+ + +-+ +-+-+-+-+-+-+ + +-+
|                 | | |   |       | | |   | |           |   |   |     |     | |     |     |       | |
+-+ +-+-+-+-+-+-+-+ + + +-+ +-+-+ + + +-+ + +-+-+-+-+-+-+-+-+-+ +-+-+ +-+ +-+ + +-+ + +-+ +-+ +-+-+ +
|   |   |           |         |   |   |     |   |   | | | | | |     |       |     |     | |     | | |
+-+ + +-+-+-+ +-+-+-+-+ +-+-+-+-+ + +-+-+ +-+ +-+-+ + + + + + +-+-+-+-+-+-+-+-+-+-+ +-+ +-+-+-+ + + +
|     | |           |   | |   |         | |   |   | |     | |     | |   | | |       |         | |   |
+-+ +-+ +-+-+-+-+-+ +-+ + +-+ + +-+ +-+ + +-+ + +-+ +-+-+ + +-+-+ + + +-+ + +-+-+ +-+-+-+-+-+-+ +-+ +
| |   |   |   |     |         |   |   | |   |       |           |     | | |     |     | | |   | |   |
+ + +-+ +-+ +-+ +-+ +-+-+-+-+-+-+-+-+ + + +-+-+ +-+-+ +-+-+-+-+ +-+ +-+ + + +-+ + +-+ + + + +-+ +-+ +
| |         |     |         |         | | |       |   |     | | |   | | |     |     | | |   |     | |
+ +-+-+ +-+ +-+ +-+-+-+ +-+ +-+-+-+-+-+ + +-+-+ +-+-+ +-+-+ + + +-+ + + +-+-+-+-+-+-+ + + +-+ +-+-+ +
|     |   | |       |     | |           |           |         | | | |             | |       |       |
+-+ +-+-+ + +-+ +-+-+-+-+-+ +-+ +-+-+-+ +-+-+-+-+-+ +-+-+-+-+-+ + + +-+ +-+-+-+-+ + +-+-+-+-+-+-+ +-+
| |       |     | | | |   | | | | | |             | |   | |   |             |       |     | |   |   |
+ +-+-+ +-+-+-+ + + + +-+ + + + + + + +-+-+-+-+-+ + +-+ + +-+ +-+-+-+-+-+-+ +-+-+-+ +-+-+ + +-+ + +-+
| |     |   | |   |   |   |       | |   |   | |             | | |   |   |   | |   |   |   | |       |
+ + +-+ + +-+ +-+ +-+ + +-+-+-+-+ + + +-+ +-+ +-+-+-+ +-+-+ + + + +-+-+ + +-+ +-+ +-+ + +-+ +-+-+-+ +
|   |   |       | | |       |       |   | | |   | | | | |   | |                 | | |   |         | |
+-+ +-+ +-+ +-+ + + +-+-+ +-+-+-+-+-+ +-+ + +-+ + + + + + +-+ +-+ +-+-+-+-+-+-+ + + + +-+-+-+-+-+ + +
| | |     |   |           |                 | |   | | |     | | | |     | | |   |         |       | |
+ +-+-+-+-+-+-+-+-+-+-+ +-+-+-+-+-+-+-+-+-+ + +-+ + + +-+-+ + + + +-+ +-+ + + +-+-+-+-+-+-+-+ +-+-+ +
| |         | | | |   | | |       | |         | |   |     |   |       | |   |     | |   |     |     |
+ +-+-+-+ +-+ + + +-+ + + +-+-+ +-+ +-+-+-+-+ + +-+ +-+ +-+-+ +-+-+ +-+ +-+ +-+-+ + +-+ + +-+ +-+ +-+
| |       |   |         |     |       | |   |   |       |     |       | |   | |             |       |
+ +-+ +-+ + +-+-+-+-+-+ + +-+-+-+ +-+ + +-+ +-+-+-+-+-+-+-+-+ +-+-+-+ + + +-+ + +-+-+-+-+-+-+-+-+-+-+
| |   |     | |             | | | |   |   | |         |             |   | |   | |       | |     |   |
+ + +-+-+-+ + +-+-+ +-+-+-+ + + +-+ +-+-+ + +-+ +-+-+ +-+-+-+-+-+-+ +-+ + +-+ + +-+-+-+ + + +-+ + +-+
|   | | | |       |       |     |       | |     | |   |           |   |     |         | |   | | | | |
+ +-+ + + +-+-+ +-+-+-+-+-+-+-+ +-+-+ +-+ +-+-+ + + +-+-+-+ +-+-+ +-+-+-+-+-+ +-+-+-+ + +-+ + + + + +
|             |                                 |           |               | |               |     |
+-+-+-+-+-+-+-+-+-+-+-+-+-+-+-+-+-+-+-+-+-+-+-+-+-+-+-+-+-+-+-+-+-+-+-+-+-+-+-+-+-+-+-+-+-+-+-+-+-+-+