+-+-+-+-+-+-+-+-+-+-+-+-+-+-+-+-+-+-+-+-+-+-+-+-+-+-+-+-+-+-+-+-+-+-+-+-+-+-+-+-+
| | |   |           | | |   |         |   |         |   |   | |                 |
+ + +-+ +-+-+-+ +-+ + + + +-+ +-+-+-+ + +-+ +-+-+-+ + +-+-+ + +-+-+-+-+-+ +-+-+-+
|         | | |   | |   | | |   | |   | | |       |     |   | |   |     |       |
+-+-+-+ +-+ + +-+-+ +-+ + + +-+ + + +-+ + +-+-+ +-+-+-+ +-+ + + +-+ +-+ + +-+-+ +
| |   |   | |   |   |           |   |     |     |   |             |   | |   | | |
+ + +-+-+ + + +-+-+ + +-+-+-+-+-+-+ + +-+ +-+ +-+ +-+ +-+-+-+-+-+ + +-+ +-+ + + +
| |   |         |       | |         | | | |         | |     |         |     |   |
+ +-+ +-+ +-+-+-+ +-+-+ + +-+-+ +-+ + + + +-+-+-+-+ + +-+ +-+-+-+-+-+-+-+-+ +-+-+
|             | |   |         | | | | | |       | | |     |         |   |     | |
+-+-+-+ +-+-+ + +-+-+-+-+-+ +-+ + + + + +-+ +-+ + +-+-+ +-+-+-+ +-+ +-+ + +-+-+ +
|           | |       | |   | |   | |     |   |   |     |         | |     |     |
+ +-+-+-+-+-+ +-+-+-+ + + +-+ +-+-+ +-+ +-+-+-+-+ +-+ +-+ +-+-+-+-+ + +-+ +-+-+ +
|     | |     |           |       |   | | |     |       | |   |   |   |   |     |
+ +-+ + +-+ +-+-+-+-+-+ +-+-+-+-+ +-+ + + +-+ +-+-+ +-+-+ + +-+-+ +-+ +-+ + +-+-+
|   | | |     | | | |   |   |   | | | |     | | |       | |   | | |   | |   | | |
+ +-+ + +-+-+ + + + +-+ + +-+ +-+ + + +-+ +-+ + +-+-+-+ + + +-+ + +-+ + + +-+ + +
| |   | |   |     |         |                 |         | | |       | | | |   | |
+-+-+ + +-+ + +-+-+-+ +-+-+-+-+-+-+-+-+-+-+-+-+-+-+-+-+-+ + +-+-+-+ + + + +-+ + +
| |   | |         |     | |   |     | |       | | |   | | |       | | | |   |   |
+ + +-+ +-+ +-+-+-+-+-+ + + +-+-+-+ + +-+ +-+ + + +-+ + + + +-+-+ + + + + +-+-+ +
|     | |     |         | |   |   |     |   |   |     |         |   |   |   |   |
+-+-+ + +-+-+ +-+-+-+ +-+ + +-+-+ + +-+ +-+ +-+ + +-+ +-+-+-+-+-+-+-+-+-+-+ + +-+
|     |           |   | | | | |   |   |   |   |   | | |   | |     |         |   |
+-+-+-+-+-+ +-+-+ +-+ + + + + +-+ +-+-+ +-+ +-+-+ + + + +-+ + +-+ +-+-+-+ +-+-+ +
|     |   | |               |   | | | |         |   |     |     |     | | | | | |
+-+ +-+ +-+-+-+ +-+-+-+-+-+ + +-+ + + +-+-+-+-+ +-+-+ +-+ + +-+-+-+-+ + + + + + +
|   | | |   |   |     |       | | |       |       | | |           |     |       |
+ +-+ + +-+ +-+ + +-+ +-+-+ +-+ + +-+ +-+ + +-+-+-+ +-+-+-+-+-+-+-+-+-+ + +-+-+-+
| | |               | |       |   | |   |   | |     |   |       |   |           |
+ + +-+-+-+-+-+-+-+-+-+-+-+-+ + +-+ +-+-+-+ + +-+ +-+-+ +-+-+-+ + +-+-+-+-+-+-+ +
|         | | | | |   |   |         |   | | | | | |       |           |   |     |
+-+-+-+-+ + + + + +-+ +-+ +-+-+ +-+-+ +-+ + + + + +-+-+ +-+-+-+ +-+-+-+-+ + +-+-+
| | | |   |   |     | | |             |     |         |       |           |   | |
+ + + +-+ + +-+-+-+ + + +-+ +-+-+-+-+-+-+-+ +-+ +-+-+-+-+-+-+ +-+-+ +-+-+-+ +-+ +
| |         |     |     |   | |   |           |     |   | |             | |   | |
+ + +-+-+-+ + +-+-+-+ +-+ +-+ +-+ +-+-+ +-+-+ +-+-+ +-+ + +-+-+ +-+-+-+ + +-+ + +
|       | | |   |             |   |   | | |   |                   |         |   |
+-+-+ +-+ + +-+ +-+ +-+-+-+-+ + +-+-+ + + +-+ +-+-+-+-+-+-+-+-+ +-+-+-+-+-+ + +-+
|   | |   |         |   | | |         |   |     |   | | | |         | |         |
+ +-+ +-+ + +-+-+-+ + +-+ + +-+-+-+-+-+-+-+ +-+ + +-+ + + + +-+-+-+ + + +-+-+-+ +
|   |     |       | |       |   | |   |       |     |             | |         | |
+-+ +-+-+-+-+-+ +-+ +-+ +-+ + +-+ +-+ +-+-+-+-+-+-+-+-+-+-+-+-+-+-+-+-+-+-+ +-+-+
| | | |       | | | |     |   |       | | |       |     | | | | |             | |
+ + + +-+-+ +-+ + + + +-+-+-+ +-+-+-+ + + +-+-+-+ + +-+ + + + + +-+ +-+-+-+-+-+ +
| |               | | | |   |       |         | |     |     |         |   |     |
+ +-+-+-+-+-+-+-+-+ + + +-+ +-+-+ +-+-+-+-+ +-+ +-+-+-+-+-+ +-+-+ +-+ +-+ + +-+-+
|       |       |     | | | |             |       | | |             |   |       |
+-+ +-+ +-+ +-+ +-+ +-+ + + +-+-+-+-+ +-+ +-+-+-+ + + +-+-+-+-+-+-+-+ +-+-+-+-+ +
|   |     |   |   |   |   |       |     |           |   |     |   | |     | |   |
+ +-+-+-+ +-+-+ +-+ +-+-+ +-+ +-+ +-+-+-+-+-+-+-+-+ + +-+-+-+ +-+ + +-+-+ + + +-+
| |     |   | |           | |   |       | |         |   |   |   |       | | | | |
+ +-+ +-+ +-+ +-+-+-+-+ +-+ +-+-+-+-+-+ + +-+-+-+ +-+ +-+-+ + +-+ +-+-+ + + + + +
|       |     |   |     | | |   |     |     |   | |       |   | |     |       | |
+ +-+-+-+-+-+ +-+ + +-+ + + + +-+-+ +-+-+-+ + +-+ +-+-+ +-+-+ + +-+ +-+-+-+ +-+ +
|         |           | | |   | | | |   |       |         |     |   |         | |
+-+-+ +-+-+-+-+-+-+-+-+ + +-+ + + + + +-+ +-+-+ +-+-+ +-+ +-+-+ +-+-+-+ +-+-+-+ +
|   | | | |           | |   | | | | | | |     |         |   | |                 |
+ +-+ + + +-+-+-+-+ +-+ + +-+ + + + + + +-+ +-+-+-+ +-+-+-+ + +-+-+-+-+-+-+ +-+-+
|   |     |             |       | | |           | |       |     | |             |
+-+ +-+-+-+-+-+-+-+-+-+ +-+-+ +-+ + + +-+-+-+-+ + +-+ +-+-+-+-+ + +-+-+-+-+-+-+ +
| |         | | | | |     |       |           | | | | |   |       | |   | | | | |
+ +-+-+-+-+ + + + + +-+ +-+-+-+ +-+-+-+ +-+-+-+ + + + + +-+-+-+ +-+ +-+ + + + + +
|   | |         | |     |               | |     |             |   |             |
+ +-+ +-+-+ +-+ + +-+-+ +-+-+-+-+-+-+-+ + +-+-+-+-+-+-+-+-+-+ +-+-+-+-+-+-+-+-+-+
|             | |             | |                 | |     |     |   |     | |   |
+-+-+-+-+-+-+-+ +-+-+-+-+ +-+ + +-+-+-+ +-+-+-+ +-+ +-+-+ +-+ +-+ +-+-+-+ + +-+ +
|   | |     |   | |       |       | | |   |         | | |   |   | | |     | |   |
+ +-+ +-+-+ + +-+ +-+-+-+-+-+-+-+ + + +-+-+-+ +-+-+ + + +-+ +-+ + + +-+-+ + +-+ +
|       |         | | |       |     |           |             |   |   |     |   |
+-+ +-+-+-+-+ +-+ + + +-+-+ +-+-+ +-+-+-+-+-+-+-+-+-+-+-+-+-+-+ +-+ +-+-+ +-+ +-+
|           | | |   |   |                   | | |                               |
+-+-+-+-+ +-+ + + +-+ +-+-+-+ +-+-+-+-+-+-+ + + +-+-+-+-+-+-+-+-+-+-+ +-+-+-+-+-+
|         |     | |   |   |         |         | |   |     | |   |   |           |
+-+ +-+-+ + +-+-+-+-+ + +-+-+-+-+-+-+ +-+-+-+ + + +-+-+-+ + +-+ + +-+-+-+-+-+ +-+
|     |   |     | |               |         | |       | | |               |     |
+-+-+ +-+ +-+-+ + +-+-+ +-+-+-+-+ + +-+-+-+-+ +-+-+-+ + + +-+-+ +-+-+-+-+ +-+-+ +
|     | |       |       |               | | | | | | | |     |   |     |   | |   |
+-+ +-+ +-+-+-+ +-+-+-+-+ +-+-+ +-+-+-+ + + + + + + + +-+ +-+ +-+ +-+ +-+ + + +-+
|     |                       |       |     |                       |   |   |   |
+-+-+-+-+-+-+-+-+-+-+-+-+-+-+-+-+-+-+-+-+-+-+-+-+-+-+-+-+-+-+-+-+-+-+-+-+-+-+-+-+