+-+-+-+-+-+-+-+-+-+-+-+-+-+-+-+-+-+-+-+-+
|               |   | | | | |     |   | |
+-+-+ +-+-+-+-+ + +-+ + + + + +-+ +-+ + +
|   | |   |     |   |       |   |       |
+ +-+ + +-+-+ +-+-+ +-+-+ +-+-+-+-+-+ +-+
| |   | |   |       | |   | | | |   |   |
+ + +-+ + +-+-+ +-+ + + +-+ + + +-+ + +-+
| |       |   |   | |       |           |
+ +-+-+ +-+ +-+ +-+ +-+-+ +-+ +-+-+-+-+-+
|   |     |       |     | |         | | |
+-+ +-+-+-+ +-+-+-+-+-+ + + +-+-+-+ + + +
|           | |     | |   | | | |       |
+-+-+-+ +-+ + +-+ +-+ +-+ + + + +-+-+ +-+
| |   | |     | |     | |     |   | |   |
+ + +-+-+-+-+ + + +-+ + +-+ +-+-+ + + +-+
| | |   |       | | |         |       | |
+ + +-+ +-+-+-+ + + +-+-+-+-+-+-+-+-+ + +
| |   |   |     | |             | | |   |
+ +-+ + +-+-+-+-+ +-+-+-+-+ +-+ + + + +-+
| |     |         |         | |   | |   |
+ + +-+ +-+-+-+ +-+-+-+-+ +-+ +-+ + + +-+
|     |   |     |   | |   | |           |
+-+-+-+-+ +-+-+ +-+ + + +-+ +-+-+-+-+ +-+
|         |   |   | |       |   |   |   |
+ +-+-+-+ + +-+ +-+ +-+-+-+ + +-+-+ +-+ +
| | | | |   |         | |     | |   |   |
+ + + + +-+ +-+-+-+-+ + +-+-+ + + +-+-+ +
| |     | |   |   |   | |   | |     |   |
+ + +-+ + +-+ +-+ +-+ + +-+ + +-+-+ + +-+
|     | | |     | |   |             | | |
+-+-+ + + +-+-+ + +-+-+-+-+-+-+-+ +-+-+ +
| |   |       |   |         |           |
+ +-+-+-+-+ +-+ +-+-+ +-+-+ + +-+-+-+-+-+
| | |         | |   |     |       |   | |
+ + +-+-+-+-+ + +-+ +-+ +-+-+-+-+ + +-+ +
| |   | | |   | | | | | |     |         |
+ + +-+ + +-+-+ + + + + + +-+-+-+-+-+ +-+
| | | | | | |   | |       | | |         |
+ + + + + + +-+ + +-+-+-+ + + +-+ +-+-+-+
| |       | |     |       |     | | |   |
+ +-+-+ +-+ +-+ +-+-+-+ +-+ +-+ + + + +-+
|   |   | | | | |   | | |     |         |
+ +-+-+ + + + + +-+ + +-+-+-+-+ +-+-+-+-+
|         | | |       | | |   |   |   | |
+ +-+-+-+ + + + +-+-+ + + +-+ + +-+ +-+ +
| |   |     |   |       |       |       |
+ +-+ +-+ +-+ +-+-+ +-+ +-+ +-+ + +-+-+ +
|   |   |   | |       |     | |     | | |
+-+ +-+ +-+ +-+-+-+-+ +-+-+-+ +-+-+ + + +
| | |         | |   | |   |   |   |   | |
+ +-+ +-+-+-+ + +-+ + + +-+-+ + +-+ +-+-+
|   | |             | | | | |   |   |   |
+-+ +-+-+-+-+-+-+-+ + + + + +-+ +-+ +-+ +
|     |       |           |     | |   | |
+-+-+ +-+-+-+ +-+ +-+ +-+-+-+ +-+ +-+ + +
|   |   |       | | |   |         | | | |
+-+ +-+ +-+-+-+ + + +-+ +-+-+-+-+ + + + +
| | |     |         | | |   | |   | | | |
+ + + +-+-+-+-+ +-+ + + +-+ + + +-+ + + +
|                 |   |             |   |
+-+-+-+-+-+-+-+-+-+-+-+-+-+-+-+-+-+-+-+-+