+-+-+-+-+-+-+-+-+-+-+-+-+-+-+-+-+-+-+-+-+-+-+-+-+-+-+-+-+-+-+-+-+-+-+-+-+-+-+-+-+-+-+-+-+-+-+-+-+-+-+-+-+-+-+-+-+-+-+-+-+-+-+-+-+-+-+-+-+-+-+-+-+-+-+-+-+-+-+-+-+-+-+-+-+-+-+-+-+-+-+-+-+-+-+-+-+-+-+-+-+
| |             | | |   |     |           | |     |     |     | | |     |     |   |         |     | | | | | | | | |       | |   | |       |   | | |     |   |       | |     |       | |   |             |
+ +-+-+-+-+ +-+ + + + +-+-+-+ +-+-+ +-+-+ + +-+-+ + +-+ + +-+ + + +-+ +-+-+-+ + +-+-+ +-+-+ +-+ +-+ + + + + + + + +-+ +-+ + + +-+ + +-+-+ + +-+ + +-+ +-+ +-+-+ +-+ + +-+-+ +-+-+-+ + +-+ +-+-+-+-+-+ +-+
| |           | |       | |   |   |   |   |       |   | |   | | |   |     | | | |     |             |             |   |                 |             |     | | |   | |           | | |       |       | |
+ + +-+-+-+-+-+ +-+-+-+ + + +-+ +-+-+-+ +-+-+-+-+ + +-+ + +-+ + + +-+-+-+ + + + +-+-+ +-+-+-+-+-+-+ +-+-+-+-+-+ +-+-+-+-+-+-+-+-+-+-+-+ +-+-+-+-+-+-+ +-+-+ + + +-+ + +-+-+-+-+-+ + + +-+-+-+ +-+ +-+ + +
| | |       |     | | |         | | |   |   |   | |   |     |   |     | | | |             |     |   |     | | | |         |       | |     |   |     | | | | |     | |       | |   |       | |       |   |
+ + +-+-+ +-+ +-+ + + +-+-+-+ +-+ + +-+ +-+ +-+ + +-+-+-+ +-+-+ + +-+ + + + +-+ +-+-+-+-+ +-+ +-+-+ +-+ +-+ + + +-+ +-+-+ + +-+-+ + +-+-+ + +-+-+ +-+ + + + +-+ +-+ +-+-+ +-+ + +-+-+-+ +-+ +-+-+-+ +-+-+
| |         |   |             | |         | | | | |         | | | | | | | |       |     |   |       | | |               | | | |   |   |   |                 |     |         |   |   | | |       | |     |
+ +-+-+-+ +-+-+-+-+-+-+-+-+-+ + +-+ +-+-+ + + + + +-+-+ +-+ + + + + + + + + +-+-+ +-+ +-+-+-+-+-+ +-+ + +-+-+-+-+ +-+-+-+ + + +-+ +-+ +-+-+-+-+ +-+-+ +-+-+-+ +-+-+-+-+-+-+ +-+ +-+ + + +-+-+-+ + + +-+-+
| |     | |       | |     |   |     |     |       | |     |   |     | |   |     |               | | | | | | |   | | | | |   |   |   | | | |   |   |   |     |   |   |         | | | |     |     | |   | |
+ +-+-+ + +-+-+-+ + + +-+ +-+ +-+-+-+-+ +-+-+-+ +-+ +-+-+-+ +-+-+-+-+ +-+ +-+ +-+-+-+-+-+-+-+-+-+ + + + + + + +-+ + + + + +-+ +-+ +-+ + + +-+ +-+-+-+ + +-+ + +-+-+ +-+ +-+-+ + + + +-+ +-+-+-+ + + +-+ +
|         |         |   | | |   | |   |     |     |   |   |   | | |   |     |           |   | | |         | | | |   |         |   |   |   |     |   |     | |   | | | |     |                 | |   |   |
+-+-+-+-+ +-+-+-+ +-+-+-+ + + +-+ + +-+ +-+-+ +-+ +-+ +-+ + +-+ + +-+ + +-+ +-+ +-+-+-+ + +-+ + +-+-+ +-+ + + + + +-+-+-+-+-+-+-+ + +-+ +-+-+-+ +-+ + +-+-+ +-+ + + + +-+-+-+-+-+-+-+-+-+-+-+ + + +-+ +-+
| | |   |   |       |     |   | |           | | |   | |         |     |   |         |               |   | |     |         |   |         |       |     |     |       |         |   |         | |   |     |
+ + + +-+-+ + +-+-+-+-+-+ + +-+ +-+ +-+-+-+ + + + +-+ +-+-+-+-+-+-+-+ +-+-+-+-+-+-+-+-+-+-+-+-+-+-+-+ +-+ +-+-+ +-+ +-+-+-+ +-+ +-+-+-+ +-+ +-+-+-+ +-+-+-+ + +-+-+ +-+-+-+-+ +-+ +-+-+ +-+ + + +-+-+-+ +
|       | |   |               |           | |   |   |       | | |   | |     |   | |       |     |       |   |     |           |       |     |     | | | | |       |   |     |     |       |     |   | | |
+-+-+ +-+ + +-+-+-+-+-+-+-+-+ +-+-+-+ +-+-+ +-+-+-+ +-+-+ +-+ + +-+ + +-+ +-+-+ + +-+-+-+ + +-+ +-+-+-+-+ +-+-+ +-+-+-+-+-+ +-+-+-+-+-+-+ +-+-+ +-+ + + + +-+-+-+-+-+ +-+-+ +-+-+ + +-+-+-+-+-+ + +-+ + +
|       | |     | | |   |         |       | |     |   |           |           |   | |     |   | |       | |   |     |   |         | |     | |   | | | |             | | | |   | |   |           | | | | |
+ +-+-+ + +-+ +-+ + + +-+-+-+ +-+ + +-+-+-+ +-+-+ + +-+-+-+-+-+ +-+-+ +-+-+-+ + +-+ +-+-+ +-+ + +-+-+ +-+ + +-+-+-+ +-+ + +-+-+-+ + +-+-+ + + +-+ + + +-+-+-+ +-+-+ + + + + +-+ +-+-+-+ +-+-+-+ + + + + +
|     |     | |       |       |         |         |       | |     |         | | |       |   | |   |         | |       |   | |   |   | | | |     |   |     |     |     |         |         |       |     |
+-+-+-+-+ +-+ + +-+-+-+-+-+-+-+-+ +-+-+-+-+-+-+-+ +-+-+ +-+ +-+ +-+-+-+-+-+ + + + +-+-+ +-+ +-+ +-+-+-+ +-+ + +-+-+-+ +-+ + + +-+-+ + + + +-+ +-+-+ +-+ +-+-+-+ +-+-+ + +-+-+-+-+ +-+-+-+-+-+-+-+-+ +-+-+
| |   |                   |   | | | |   | |             |   | |   | |     | | |   | |     |   | |   | |   |       |     | |   |       |     |     |   |         |   |   |         |     | |   |     |   |
+ + +-+ +-+-+-+-+-+-+-+-+ +-+ + + + + +-+ +-+-+-+-+-+-+ +-+ + +-+ + +-+-+ +-+ +-+ + + +-+ +-+ + +-+ + +-+ +-+-+-+ +-+ +-+ + +-+-+-+ +-+-+-+ + +-+ +-+-+ +-+-+-+ + +-+-+-+-+-+ +-+ + +-+ + + +-+ +-+ + +-+
|       | |                     | | |         |   |   |   |   |         | | |     |     |   |             |   | | | | | |   | |           | |   |   |     |   |   |   |       | |     |       | |   |   |
+-+-+-+ + +-+-+-+-+ +-+-+-+-+-+-+ + +-+ +-+-+ + +-+-+ + +-+-+ +-+ +-+-+ + + + +-+-+-+-+-+-+ +-+-+-+ +-+-+ + +-+ + + + + +-+ + +-+-+-+-+ +-+ +-+-+ +-+-+ +-+ +-+ +-+ +-+-+ +-+ + +-+ +-+-+-+-+ +-+-+ + +-+
|     | | | |   |       | | |       |   |   |   |   |   |   |   |     | | | |   |             |     |   | | | |   |       | | |           |   |   | | | |       | |   | |   | | |   | | | |     |     | |
+-+-+ + + + +-+ +-+ +-+ + + +-+-+-+ + +-+-+ +-+ +-+ + +-+-+ +-+ +-+-+-+ + + +-+-+-+ +-+-+-+-+ + +-+ +-+ + + + + +-+ +-+ +-+ + + +-+-+-+-+-+-+ +-+ + + +-+-+-+ +-+ + +-+ +-+ + + + +-+ + + + +-+ +-+-+ + +
|             |       | |   |   |   | |     |   |         | | | | |     |   |     | |             | |     | |     | |         |   | |                 |             |   |   | |         | | |     |     |
+ +-+-+-+-+-+-+-+-+-+-+ +-+ + +-+ +-+ + +-+ + +-+ +-+-+-+ + + + + + +-+ +-+ +-+-+ +-+ +-+-+-+-+-+ +-+-+-+ + +-+ +-+-+-+-+-+-+ +-+ + +-+-+-+ +-+-+-+-+ +-+-+-+ +-+-+ +-+ +-+-+-+-+ +-+-+ + +-+ +-+ + +-+-+
|     |   |   |   |     | | | |       | | | | | |   |       | |   |   |   |     | |   |   |     | | | | | |             |       |       |     |       |   |   |   |             | |     |     |   |     |
+-+ +-+ +-+-+ + +-+-+ +-+ + + +-+-+ +-+ + + + + +-+ +-+-+-+ + + +-+-+ +-+ +-+ +-+ +-+ + +-+-+-+ + + + + +-+-+-+-+ +-+-+-+-+-+-+-+ +-+-+-+-+-+-+-+-+-+ + +-+-+ + +-+-+-+-+-+-+-+-+ +-+-+-+-+-+ +-+ +-+-+ +
|       |       | | |       |   |     | | | | |           |   |   | |   | | |     |       |                 |   | |     |     |         | | |     | | |     | | |         |   | |     | | |   | |       |
+ +-+-+ +-+ +-+ + + + +-+-+-+-+ +-+-+ + + + +-+-+-+ +-+-+-+-+ + +-+ +-+-+ + +-+ +-+-+-+-+-+-+-+-+ +-+-+-+-+ + +-+ + +-+ +-+-+ + +-+-+-+ + + +-+-+ + + +-+ +-+ + +-+-+-+ +-+ +-+ +-+ +-+ + +-+ + + +-+-+-+
|   | | | |   | |   |   |   | |     | |   | | |     |   |   |     | |   |   | | |         |   |       |     | |     |     | | | | |         |             | |     | |     |   | |   | |     |   |   | | |
+-+ + + + +-+-+ +-+ +-+ +-+ + + +-+ + +-+ + + + +-+ +-+ +-+ + +-+ + + +-+-+ + + +-+-+-+ +-+ +-+-+-+-+ +-+-+ + +-+-+-+ +-+ + + + + +-+-+-+-+-+-+-+-+-+-+-+ + +-+ +-+ +-+ +-+-+ + + +-+ + +-+ +-+ +-+ + + +
|     |           | |           |   | | | |     | |     | | |   | |     |   | | |     | |   | |         | | |   |     |           |           | |           | | |   | |   |   |           |   |   |     |
+-+-+-+-+-+-+-+-+ + +-+-+-+-+ +-+-+-+ + + +-+-+ + +-+ +-+ + +-+ + +-+-+ + +-+ + +-+-+ + + +-+ +-+-+-+ +-+ + + +-+-+-+ +-+-+-+-+-+ +-+ +-+-+-+ + +-+ +-+-+-+ + + +-+ + + +-+ +-+-+-+-+-+-+-+-+-+-+-+-+ +-+
|   |   |   | |   |   |     | |       |     |       |         | | | | |   | |     |       |   | |       | | | |           | | | | |         | |   | |   | | |   | |     | |     |       |     |         |
+-+ +-+ + +-+ + +-+ +-+-+-+ +-+-+-+-+-+-+ +-+-+-+-+-+-+-+-+-+-+-+ + + + +-+ +-+ +-+-+ +-+ + +-+ +-+-+-+ + + + +-+-+-+-+-+ + + + + +-+-+-+-+-+ +-+ + + +-+ + + +-+ +-+ +-+ + +-+ + +-+-+ +-+-+ +-+ +-+-+-+
| |   | | |       | |   | |       | |                           | |             |     |   |           |   |   | |   | | |     |   |   |   | |   | |       |     | |     |   |     |         | |     |   |
+ + +-+ + + +-+ +-+ + +-+ + +-+-+ + +-+-+-+ +-+-+ +-+-+-+-+-+-+-+ + +-+-+-+-+-+-+-+-+-+-+ + +-+-+-+-+ +-+ +-+ + +-+ + + +-+-+-+-+ + +-+-+ + + +-+ +-+-+-+-+-+-+ + +-+-+ +-+-+-+-+ +-+-+-+-+ + +-+ +-+-+ +
|     | |     |   |           | |   |       |     |     |   |   |   |     |   | | | | |     |   |     | | | |       |   | | |           |   |     | |   | |     | |     |       |         |       |   | |
+ +-+ + +-+-+-+-+ +-+ +-+-+-+ + + +-+-+ +-+-+-+-+ +-+-+ +-+ + +-+-+ +-+-+ + +-+ + + + +-+-+ + +-+-+ +-+ + + + +-+-+ + +-+ + +-+-+-+-+-+ +-+ +-+-+ + +-+ + + +-+ + +-+-+ +-+-+ +-+-+-+-+-+-+-+-+ +-+ +-+ +
| | |         | | |       |     |       | |                   |             | | | |     | |       |         | |       |     | |   |   |   | | |         |     |   |   | |     | | |       | |     | |   |
+ + +-+ +-+-+ + +-+-+-+-+-+-+-+-+-+-+ +-+ +-+-+-+ +-+-+-+ +-+-+-+-+ +-+-+-+ + + + + +-+ + +-+-+-+-+-+-+-+ +-+-+-+-+-+ + +-+ + + +-+-+ +-+ + + +-+ +-+-+ +-+-+-+ +-+ +-+ +-+ +-+ + +-+-+-+ + +-+-+ + +-+ +
|     | |   |   |   |                   |   |   |     |     |   |   |   | | | |       |   |         |         |   |     | |         | | | |     |     |         |   |   |                   |           |
+-+-+-+ +-+ + +-+-+ +-+-+-+-+-+-+-+ +-+ + +-+ +-+-+-+ +-+-+ + +-+ +-+ +-+ + + +-+-+-+-+-+ +-+-+-+-+ +-+-+-+ +-+-+ + +-+ + +-+-+-+-+ + + + +-+-+ +-+-+-+-+-+ +-+ +-+ +-+ +-+-+-+-+-+ +-+-+-+-+-+-+-+ +-+-+
|     | |   |   | | |               |   |   |             | | | |       |   |   |   |     |   |   |     |   |       | |       |   |     | |     |   | |       | | | |                       |       | | |
+ +-+ + +-+ + +-+ + +-+-+-+-+-+-+-+ +-+ + +-+-+-+ +-+-+-+-+-+ + +-+-+-+-+ +-+ +-+ +-+ +-+ + +-+-+ +-+ +-+-+-+-+-+-+ + +-+-+ +-+-+ +-+ +-+ + +-+ +-+ + +-+-+-+ + + + +-+-+-+-+-+ +-+-+-+-+-+-+-+-+-+ + + +
| |   | |           | |     | |   |   |   |     |         | |     | | |       | |       |     | |   |   |   |           |     | |       |   | |       |       |       | |                     | |       |
+-+-+ +-+ +-+-+-+-+ + +-+ +-+ +-+ +-+-+ +-+ +-+ +-+-+-+ +-+ +-+ +-+ + +-+-+-+ + +-+-+ +-+-+-+ + + +-+ +-+-+ +-+-+-+-+-+-+-+-+ + +-+-+ +-+-+ + +-+-+-+-+-+ +-+-+-+-+-+ + +-+-+-+-+-+-+-+-+ +-+ + +-+-+ +-+
|       | | | |   | |     | |       | |       |       | | | |   |   |   | |   |   |       |           | |   | |   |           | |       | |   | |     |     | |           |   |   |         |   |   |   |
+-+-+ +-+ + + +-+ + + +-+ + +-+-+ +-+ +-+-+-+-+-+-+-+-+ + + + +-+ +-+-+ + +-+ +-+ +-+-+-+ +-+-+-+-+-+ + +-+ + + +-+-+ +-+-+-+ + +-+-+ +-+ + +-+ + +-+ +-+ +-+ +-+ +-+-+-+ +-+ +-+ +-+-+-+-+-+-+ + +-+-+ +
| | | |         |   |   |     |       | |   |   |                 | |     |           |         |   | | |   | |       |     |       |   |           |   |     |   |     |   | |       |   |       | |   |
+ + + +-+-+-+ +-+-+ +-+-+ +-+ +-+-+ +-+ + +-+-+ +-+ +-+-+-+-+ +-+ + + +-+ +-+-+-+-+-+ +-+-+ +-+ + +-+ + + +-+ +-+-+-+ +-+-+ +-+-+-+-+ +-+-+ +-+-+-+ +-+-+-+-+-+-+ +-+-+ + +-+ +-+-+ +-+ +-+ +-+-+ + +-+ +
|         | | |     |   |   | | |           | |     | |   |     |     | |     |         | |   |   | |       | |     |   | |   |     |   |       |     |   |   |   |         |   | | | |   | |     | |   |
+-+-+ +-+ + +-+-+ +-+-+ +-+ + + +-+ +-+-+-+ + +-+ +-+ +-+ +-+ +-+-+-+ + +-+ +-+-+-+-+-+ + +-+-+-+ + +-+ +-+ + + +-+ + +-+ +-+ +-+ +-+-+ +-+-+-+-+-+-+ + +-+ +-+-+-+-+-+-+-+ + +-+ + + +-+ +-+ +-+ + + +-+
|       |       |           | | | |     | | | |       | |   | | | |       | |   |       |       | | |   | |       |   |     | | |   |   | |     | |         |           |             |   | | | |   |   |
+-+-+-+-+-+-+ +-+ +-+-+-+-+-+ + + +-+ +-+ + + + +-+-+ + + +-+ + + +-+-+-+ + +-+ +-+-+ +-+-+-+ +-+ + + +-+ +-+-+-+-+ +-+-+-+ + + +-+ +-+ + +-+-+ + +-+-+-+-+ +-+-+-+-+ +-+-+-+-+ +-+-+ + +-+ + + + +-+-+ +
| |             | | | |   |           | |   | |     |       |   |     | | |   |   |     | | |     |             |         |         | | |       | | |       | |   | | | |   | | | |       |   |       | |
+ +-+ +-+-+-+-+ + + + + +-+-+ +-+-+-+ + +-+ + +-+-+-+-+-+-+-+-+ + +-+ + +-+ +-+ +-+ +-+ + + +-+-+-+-+-+-+-+-+ +-+ +-+-+-+ +-+-+-+ +-+ + +-+-+ +-+ + + +-+-+ + +-+ + + + +-+ + + + +-+ +-+ +-+-+-+ +-+-+ +
| | |   |   |       |   |     |     |   |   | |         |   | |     |     |     | | |   | |   |       | |   | |     |     | |       |       |       | | |   |   |         |   |     |   | |         |   |
+ + +-+ +-+ + +-+-+ +-+ + +-+ + +-+ + +-+-+ + +-+-+ +-+ +-+ + +-+-+-+-+-+ +-+-+ + +-+ +-+ + +-+ +-+-+ + + +-+ +-+-+-+-+-+ + +-+ +-+ +-+-+-+ +-+ +-+ + + + +-+-+ +-+ +-+-+ +-+ +-+-+-+-+ + + +-+-+-+ + +-+
|       |   |     | | |     |     | | |   |   |   |   |         | | | |       | |     |   |         |       | |   | |       |     | | | |     | | | |   | |     |   |   |   |   |       |     |   | |   |
+-+-+ +-+-+ +-+-+-+ + +-+ +-+-+-+-+-+ + +-+ +-+-+ +-+-+-+-+-+-+ + + + +-+-+-+-+ +-+-+ +-+ +-+-+-+ +-+-+-+-+ + + +-+ +-+-+-+ +-+-+-+ + + +-+-+ + + + +-+ + +-+ +-+ +-+-+ +-+ +-+ +-+-+-+-+-+ +-+ +-+-+-+ +
|                 |   |       |   |     | |   | | |         | |     |     |     |   |               |   |                 | |     |     | |   |   |     | |       |     |     | | |   | |           | | |
+-+-+-+-+-+-+-+ +-+-+-+-+-+-+ + +-+-+-+ + + +-+ + +-+-+-+-+ + +-+ +-+-+-+ +-+ +-+-+ +-+-+-+-+-+-+ +-+-+ +-+-+-+-+-+ +-+-+-+ + +-+ +-+ +-+ +-+-+-+-+-+-+-+ +-+-+ +-+-+-+ + +-+ + + + +-+ +-+-+-+-+-+ + + +
|   | |   |             |   | | |         | |   |               |       |     | | | |   | |         |         |       | | |   | |           | |       |   | | |       | |   |       |   |         | |   |
+-+ + +-+ +-+-+ +-+-+-+ + +-+ + +-+-+-+-+-+ +-+ +-+-+ +-+-+-+-+ +-+ +-+ +-+-+ + + + + +-+ + +-+-+-+ +-+-+ +-+ +-+ +-+ + + +-+ + +-+ +-+-+-+ + + +-+-+ + +-+ + +-+-+-+ + + +-+-+-+-+ + +-+-+-+-+ +-+-+-+ +
|       | |           |   |     |   |   | |   |         |     | |   |     | | |                 | | | |     | |     |     | |     |   |   |   | |   |   | |     |     | |       |       |       |   | | |
+-+-+-+ + + +-+-+-+-+-+-+-+-+-+ +-+ +-+ + +-+ +-+-+ +-+ + +-+ + +-+-+-+ +-+ +-+-+-+-+ +-+-+-+-+ + + + +-+ +-+ +-+-+-+ +-+ + +-+-+-+-+ + +-+-+ + + +-+ +-+ +-+-+ + +-+ + +-+-+ +-+ +-+-+ + +-+-+ + +-+ + +
|     | | | |   | |   | | |     |             |     | |   |   | |       | |   |   | | |     |   | |         |       |   | | |       |   |   | |   | |     | |   | |   |       | |     | |     |     |   |
+-+ +-+ + + +-+ + +-+ + + +-+ +-+-+-+-+-+-+-+ + +-+ + + +-+-+-+ +-+-+-+ + + +-+ +-+ + +-+ +-+-+ + +-+ +-+-+-+-+-+-+-+-+-+-+ +-+-+ +-+ +-+-+ +-+ +-+ +-+ +-+ + +-+-+-+-+ +-+-+ + + +-+ + + +-+-+-+-+ +-+ +
|   | | | | |         |   | |           | | |     | | | |               | |     |   | | |     |     |         | |       |   | |     |     |     |   | | | |   |             |   |   | | |   | |     | | |
+ +-+ + + + + +-+-+-+ +-+ + +-+-+-+ +-+ + + +-+ +-+ + +-+-+-+-+-+-+-+ +-+ + +-+ +-+ + + +-+ +-+-+ +-+-+-+-+-+ + + +-+-+ + +-+ + +-+ + +-+-+-+-+ +-+ + + + + +-+-+-+-+-+-+-+-+-+-+-+-+-+ + +-+ + +-+ + + +
| | |   |         |               | | |   | |     |   |       | |     |       | |   | | | | |   | | | |       |       |       | |     |         | |           |         |     |   | |         |   |   | |
+ + + +-+-+-+-+-+-+-+-+-+-+-+-+ +-+ + +-+ + +-+-+-+-+ + +-+-+ + + +-+ +-+-+-+-+ +-+ + + + + + +-+ + + + +-+-+ +-+ +-+-+-+-+-+ +-+-+-+-+-+-+-+ +-+ +-+-+-+ +-+ +-+-+ +-+ +-+ +-+ +-+ +-+-+-+-+-+-+-+ +-+ +
|     |   | |           |   |     |     | |         | | |       |   |         | | |         | |     |       | |     | |   | |         |   |     |   | | |   |   | | | |                   |     |     | |
+-+ +-+-+ + +-+-+ +-+-+ +-+ +-+-+-+-+ +-+ + +-+-+-+ + +-+-+ +-+-+-+ +-+-+-+-+ + + +-+-+-+-+ + +-+-+-+-+-+-+-+ + +-+ + +-+ + +-+-+-+-+ + +-+ +-+-+-+ + + +-+-+ +-+ + + +-+-+-+-+-+-+-+ +-+-+ +-+ +-+-+ + +
| | | |     |   |     | |   |   | |     | |   | |     |   |             |       | | |     |   |       | | | | | |   |     |   |         | |     |   |     | |     |   | |   | |     | | | |   | | |   | |
+ + + +-+ +-+-+ + +-+-+ +-+ + +-+ +-+-+-+ +-+ + + +-+ + +-+ +-+-+-+-+-+-+-+-+-+ + + +-+-+ +-+ +-+-+ +-+ + + + +-+ +-+ +-+ +-+ + +-+-+-+ + +-+-+ +-+ +-+ +-+ +-+ +-+ +-+ +-+ + +-+ +-+ + + +-+-+ + +-+ + +
|         |   |       |   |   |     | | |   | |     |   |       |   |   |               |     | | |       |   |   |     | | |   | | | |   |   | | |   |   |     |     | |     | | | |   |     |   |     |
+ +-+-+-+ + +-+-+-+ +-+-+ +-+ + +-+ + + + +-+-+-+-+-+-+-+-+-+-+ +-+ +-+ +-+-+-+-+-+ +-+ + +-+ + + +-+-+ +-+ +-+ +-+-+-+-+ + +-+ + + + + +-+ +-+ + + +-+-+ + +-+ +-+ +-+ +-+ +-+ + + +-+ +-+ +-+-+ +-+ +-+
| |     | |   |   |     |   | | |               | |   |         |     |       |   | |   | |       | | |   |         |   | | | |   |   |   |       |   | | |   | | | | |   |         | |   |     | |   | |
+ +-+ +-+ + +-+ +-+-+ +-+-+ + +-+-+ +-+-+-+-+-+ + +-+ +-+-+ +-+-+-+-+ +-+ +-+ +-+ +-+ +-+-+-+-+ +-+ + +-+ + +-+-+-+ +-+ + + + +-+ + +-+-+-+ +-+-+ +-+ + + +-+ + + + + + +-+-+-+-+-+ + +-+ +-+-+ + +-+ + +
|   |     | |   |       | | |   | |     |           |   |   |       | | |   |           |     | | | | | | |     |               |     | |       | | | | |     |     | |   |   | |     | | | |     | |   |
+-+ +-+-+ + +-+ + +-+-+-+ + + +-+ +-+-+-+ +-+-+-+-+ +-+ +-+ +-+ +-+ + + +-+ +-+-+-+-+-+ + +-+ + + + + + + +-+-+-+-+-+-+ +-+-+-+-+-+-+ + +-+-+-+ + + + + + +-+-+-+-+ + +-+ +-+ + +-+-+ + + + +-+-+ + +-+ +
| |     |           |   |   | | | | |           | |       |       |   |           | |   | |                 | | |     | | | |     |       |   | |     |   | |         |   |         |           |     | |
+ +-+-+-+-+-+-+-+-+ + +-+ +-+ + + + + +-+-+-+ +-+ +-+-+ +-+-+-+ +-+-+-+-+-+-+-+ +-+ +-+ + +-+-+-+-+-+-+-+-+ + + +-+ +-+ + + +-+-+ +-+ +-+ +-+ + +-+-+-+-+ + +-+-+-+ +-+-+ +-+-+ +-+ +-+ +-+-+-+ +-+ +-+ +
|       | | | | | |     |     |       |     |     |   | |     |       |   |         |   | |   |     |         |         |   |   |       |   | | | | | | |         | |       |     |         | |       | |
+-+ +-+ + + + + + +-+-+-+-+-+ +-+-+ +-+ +-+ + +-+ +-+ + + +-+ +-+ +-+ + +-+ +-+-+-+-+-+ + +-+ +-+-+ +-+-+-+-+-+-+-+-+ +-+ +-+ +-+-+-+-+-+-+ + + + + + + +-+-+ +-+-+ +-+ +-+-+-+-+-+-+ +-+-+ + + +-+-+-+-+
|   | | | |     |   | |   | | |           | |   |   |     |   | | |       | |   | |   |       |         |   | |       |     |   |   | |     |   | |     |   | |       |       |   | | |   | |     |     |
+ +-+ + + + +-+ + +-+ + +-+ + +-+-+ +-+-+-+-+-+-+-+-+-+-+-+-+ + +-+-+-+-+-+ +-+ + +-+ +-+-+ +-+-+ +-+-+ + +-+ +-+ +-+ +-+ +-+-+ + +-+ +-+-+ +-+ + + +-+ +-+ +-+ +-+-+ +-+-+ +-+-+ + + + +-+-+-+-+ + +-+-+
|     | |   |         |   |   |       | | |       | | |     | |   |             |           | |   |   |           |       |         |         |       | |       |       |         | | |   |   | |   |   |
+-+-+ + +-+-+-+-+ +-+ +-+ + +-+-+-+-+ + + +-+-+ +-+ + +-+ +-+ + +-+-+-+-+-+-+-+-+-+-+-+-+ +-+ + +-+ +-+-+-+-+-+-+-+ +-+-+ +-+-+-+ +-+-+-+-+-+-+ +-+-+-+-+-+-+-+-+-+-+-+ +-+-+-+ +-+ + + +-+-+ + +-+ + +-+
| | | | | | |   |   |   | | |     |     |     | |       |     |   | | |           |   |       |       | | |   | |       |   |     | |     | | |     | |     |   |       |     |         | |             |
+ + +-+ + + + +-+-+ +-+ + + + +-+-+-+-+ +-+ +-+ +-+ +-+ + +-+ + +-+ + +-+-+-+-+-+ +-+ +-+-+-+-+-+-+ +-+ + + +-+ +-+-+ +-+-+ +-+-+ + +-+ +-+ + +-+ +-+ + +-+ + +-+-+-+-+ + +-+ +-+-+-+ +-+ +-+-+-+ +-+-+-+
| |     |     |   |   | | | |       | |     |   |   | |     |     |       |     | | |   |               |       |       |   |         |             |   |   |       |       |   |           | |     |   |
+ +-+-+ +-+-+ + +-+-+ + + + + +-+-+ + +-+ +-+ +-+-+ + +-+ +-+-+-+ + +-+-+ +-+ +-+ + +-+ +-+-+-+-+-+ +-+ +-+ +-+ +-+-+-+ +-+ + +-+-+-+ +-+-+ +-+-+-+ +-+ +-+ + +-+-+ +-+ +-+-+-+-+-+-+-+-+-+ + + +-+ + +-+
| |             | |   |     |     |     |     | |       |       | |   |         |           |     |   |     |   | |   |   |       | | | | |   |   |     |         | |       |   |     |       |   |   | |
+ +-+-+ +-+-+-+ + +-+-+-+ +-+-+ +-+-+-+ + +-+ + + +-+-+-+-+-+-+-+ +-+-+-+-+-+ +-+-+ +-+-+-+ +-+ +-+ +-+-+-+-+-+ + +-+ +-+-+-+ +-+ + + + + + +-+-+ +-+-+ +-+-+-+-+-+-+-+-+-+ +-+ +-+ +-+-+-+-+-+ +-+-+-+ +
|     |       |     | | | |           | | | |   | | | | |     |         | | |   |   | | |   | | | | | | |   | | | | | | |   |   |   | |           | |               |           | | |   | |   | | |     |
+ +-+ + +-+-+-+-+-+ + + + +-+ +-+-+-+-+ + + +-+ + + + + + +-+ +-+-+-+ +-+ + +-+ +-+ + + + +-+ + + + + + + +-+ + + + + + + +-+-+-+-+-+-+-+-+-+-+ +-+ +-+-+-+-+ +-+-+-+-+-+-+-+-+ + + +-+ + +-+ + + +-+-+ +
|   | |   |       | |     |       | | |       | | | | |     | | |   | | |     | | |     | |     | |   |           | | | |   | | |         |       |   |             | |   | |     | |           |       |
+-+ +-+ +-+-+-+-+ + + +-+ +-+ +-+ + + +-+-+-+-+ + + + +-+ +-+ + + +-+ + + +-+ + + + +-+-+ +-+-+ + +-+-+-+-+-+-+ +-+ + + +-+ + + + +-+-+-+ +-+ +-+ +-+ + +-+-+-+-+-+ + +-+ + +-+ +-+ +-+-+-+ +-+ +-+ +-+ +
| |   | | | | |       |   |   |         |     | |   |       |         |     |       |         |   | | |           |                     | | |   |     |   |                   |   | | |       |   |   | |
+ +-+ + + + + +-+-+ +-+-+ + +-+-+-+-+-+ +-+-+ +-+-+-+ +-+-+ +-+-+-+-+ +-+-+-+-+-+-+-+-+-+ +-+ + +-+ + +-+-+ +-+-+-+-+-+-+-+-+-+ +-+-+-+-+ + +-+-+-+-+-+-+-+-+-+-+-+ +-+-+-+-+-+-+ + + + +-+-+-+-+ + +-+-+
|     | |     |     |     |     |   | |       |     | | |           | | |   | |   | |   | |     |   |     |   | |   |     | |   |   |       | |         |     |             |     | | | | |     |       |
+-+ +-+ +-+ +-+-+-+-+-+ +-+ +-+ + +-+ +-+ +-+ +-+-+ + + +-+-+-+-+-+ + + + +-+ +-+ + + +-+ +-+-+ + +-+ +-+ +-+ + + +-+-+-+ + + +-+-+ +-+ +-+ + + +-+-+-+ +-+-+ +-+-+-+-+-+-+ +-+-+ + + + + +-+ +-+-+-+-+ +
| |     |   |   |           |       |     |     | | | |     |   |   |           |     |     | |         |   |   |       | |   | |     | | | |       | |   | | |         | |     |     | | | |       |   |
+ + +-+ +-+ +-+ +-+-+-+-+ +-+-+-+-+-+-+-+-+-+-+ + + + + +-+ +-+ +-+-+-+-+-+-+ +-+-+-+ + +-+ + +-+-+-+-+ +-+ +-+ + +-+-+-+ + +-+ +-+ +-+ + + + +-+-+ + + +-+ + +-+ +-+-+ + +-+-+ +-+-+-+ + + +-+ +-+ +-+ +
|   |         |               |       | |       |         | |   | |               | |     | | | | |   |   | |     |   |       |   |       |       | |       | |       |     |   |   | | |       |       |
+-+-+-+-+-+-+-+-+-+-+-+-+ +-+ +-+ +-+ + +-+ +-+-+-+-+-+-+-+ + +-+ + +-+-+-+-+-+-+ + +-+ +-+ + + + + +-+-+-+ +-+-+ + +-+-+-+ +-+ +-+-+-+-+-+-+-+-+-+-+ +-+-+ + + +-+-+-+-+-+ +-+ + +-+ +-+-+ +-+-+-+-+-+-+
|   | |   | | | |   |   |   | |     | | | | |         |     | | |   |       | |           | |       |     | |   |   |   | |   |     |     | | | | | |     | |   | | |           | | |     |   |       | |
+ +-+ + +-+ + + + +-+ +-+ +-+ +-+-+ + + + + + +-+-+-+ +-+ +-+ + + +-+-+-+-+ + +-+-+-+-+-+ + + +-+-+ +-+ +-+ + +-+-+ + +-+ +-+ +-+-+ +-+ +-+ + + + + +-+-+ + +-+ + + + +-+ +-+-+ + + +-+ +-+-+ +-+ +-+-+ +
|   |   | | |   | | | | |   | |   | |         |   | | |       | |       |   |         |   |   |   |       | |     |   |   |               |         | |   | |   | | | |   | | | |     |     |   |       |
+ +-+ +-+ + + +-+ + + + +-+ + +-+ +-+ +-+-+-+ +-+ + +-+-+ +-+ + +-+-+-+ + +-+-+ +-+-+ +-+-+-+ + +-+-+-+ +-+ +-+ +-+-+ + +-+-+-+-+-+ +-+-+ +-+-+-+ +-+ + +-+ +-+ + + +-+ +-+ + + +-+ +-+-+-+ + +-+-+-+ +-+
|   | | |     |             |   |   |   |   | |     | | |   |     |   |         |     | |     |   |       |   |               | |     |   |   |     |   |           |   | |           |   |     | |     |
+ +-+ + +-+ +-+-+-+-+-+-+-+ +-+ + +-+-+ +-+ + +-+ +-+ + + +-+-+-+ + +-+-+-+-+ +-+-+-+ + + +-+ +-+ +-+-+-+-+-+-+ +-+-+-+-+-+-+ + +-+ +-+-+ + +-+-+-+ +-+-+-+ +-+-+-+-+-+ + +-+-+-+ +-+ +-+ +-+ +-+ + +-+-+
|                             |       |   |             |       |       |           |   |   |             |                 |     |     |                 |         |         |     |     |             |
+-+-+-+-+-+-+-+-+-+-+-+-+-+-+-+-+-+-+-+-+-+-+-+-+-+-+-+-+-+-+-+-+-+-+-+-+-+-+-+-+-+-+-+-+-+-+-+-+-+-+-+-+-+-+-+-+-+-+-+-+-+-+-+-+-+-+-+-+-+-+-+-+-+-+-+-+-+-+-+-+-+-+-+-+-+-+-+-+-+-+-+-+-+-+-+-+-+-+-+-+