+-+-+-+-+-+-+-+-+-+-+-+-+-+-+-+-+-+-+-+-+-+-+-+-+-+-+-+-+-+-+-+-+-+-+-+-+-+-+-+-+
|     |       | |     |         |         |   |   |   |           | |     |   | |
+-+ +-+-+-+-+ + + +-+-+-+-+-+ +-+ +-+-+-+ + +-+ +-+-+ +-+-+-+-+ +-+ + +-+-+-+ + +
|   |     | |   |   | |     |   | |   | |   |       |       | |       |     | | |
+-+ +-+ +-+ +-+ +-+ + +-+ +-+-+ + +-+ + + +-+-+-+-+ +-+-+ +-+ +-+-+-+ +-+-+ + + +
| |       | |       |     |         |         | |           |         | | |     |
+ + +-+-+ + +-+ +-+ +-+ +-+-+-+-+-+-+-+-+ +-+ + +-+ +-+ +-+ +-+-+ +-+ + + +-+-+ +
|   |     | | | | |   |     | |           |   |   |   |   | | |   |   | |     | |
+-+-+-+-+ + + + + +-+ + +-+ + +-+-+-+-+ +-+-+ +-+ +-+-+-+-+ + +-+-+-+ + + +-+-+ +
| |     |           |   |   | |   |     |   | | | | | | |     |   |     |     | |
+ +-+ +-+ +-+-+-+-+-+-+-+-+ + + +-+-+ +-+ +-+ + + + + + + +-+ + +-+-+ +-+-+ +-+ +
|       |   |   |       |       | |   | |       |   |     |     |       |       |
+-+-+-+ + +-+ +-+-+ +-+ +-+-+-+ + + +-+ +-+-+ +-+-+ +-+-+-+-+-+ +-+-+ +-+-+ +-+-+
|   |       |     |   | | | |   |     |       |   |       |   | |     |     |   |
+ +-+-+-+-+ + +-+ +-+ + + + + +-+-+-+-+ +-+-+ +-+ +-+ +-+ + +-+ +-+ +-+ +-+ + +-+
|       |       |     |     |       |     |   | |     |                   |     |
+-+-+ +-+ +-+ +-+-+-+-+-+-+-+ +-+-+ +-+-+-+ +-+ +-+-+-+-+ +-+-+-+-+-+-+-+-+-+-+-+
|   |       |               | | |     |   |   | |       |       | |       | | | |
+-+ +-+ +-+ +-+-+ +-+-+-+-+-+ + + +-+ +-+ +-+ + + +-+-+ +-+-+-+ + + +-+-+ + + + +
|         | |   |       |     | | | |       | |   | |   | | |   |       |     | |
+-+ +-+-+-+ + +-+-+-+-+-+ +-+ + + + +-+ +-+ + + +-+ +-+ + + + +-+-+ +-+-+-+-+-+ +
|       | |     | | |       |   | |     |         | |   | | | | | |         |   |
+-+-+ +-+ +-+ +-+ + +-+-+-+-+-+-+-+-+ +-+-+-+-+-+ + +-+ + + + + + +-+-+ +-+ + +-+
|       |   |         | | | | |     |   | |       | | |       | |   |   | | |   |
+ +-+-+-+-+ +-+ +-+-+ + + + + +-+ +-+ +-+ +-+-+ +-+ + +-+-+-+ + +-+ +-+ + + +-+ +
| |             |   | | |     | |           | | | |     |   |   | |   |   | |   |
+-+ +-+-+-+-+-+ +-+ + + +-+ +-+ +-+-+-+-+ +-+ + + + +-+ + +-+ +-+ + +-+ +-+ + +-+
|     | |   |   |     |   | |     | |     |     |     | |   | |   | |   | |     |
+-+-+ + +-+ +-+-+ +-+ +-+ + + +-+ + +-+-+ +-+-+ +-+-+-+ +-+ + +-+ + + +-+ +-+-+ +
| | | |       | |   |       | |       |   |           | | | |   |   |         | |
+ + + +-+-+-+ + +-+-+-+ +-+ +-+-+-+ +-+-+-+-+-+ +-+-+ + + + + +-+ +-+ +-+-+-+-+-+
|     |   |   | | |     | | | | | |                 |     |     |   |   |       |
+-+-+ + +-+-+ + + + +-+ + + + + + + +-+-+-+-+-+-+ +-+-+-+-+-+-+ + +-+-+ +-+-+ +-+
|         |       | |     |       |             |       |               |     | |
+-+-+-+ +-+-+ +-+-+-+-+ +-+-+-+-+-+-+-+ +-+-+-+-+-+-+-+-+-+-+-+-+-+-+-+-+-+-+ + +
|       |   |   |   |   | | |     |     |     |   | | |   |   | |         | |   |
+ +-+-+ + +-+-+ + +-+-+ + + + +-+ +-+-+ + +-+ + +-+ + + +-+ +-+ +-+-+-+-+ + + +-+
|     |     |     |       | |   |         | |       |     | |           |     | |
+-+-+-+-+ +-+-+-+ +-+-+-+ + +-+-+-+-+ +-+ + +-+ +-+ +-+ +-+ +-+-+-+-+ +-+-+ +-+ +
|   |   |   |     |                 | |   |   | | | | | | |     | | |   |       |
+ +-+ +-+-+ +-+-+ +-+-+-+-+-+-+ +-+-+ +-+ +-+ + + + + + + + +-+ + + + +-+ +-+-+-+
| |   |     |   | | |           |   | |   |     |   |         |     |           |
+ + +-+-+-+ +-+ + + +-+ +-+-+-+ +-+ +-+-+-+-+-+-+ +-+-+-+-+-+-+-+ +-+ +-+-+-+-+-+
|   |   | | | | |   | |       |         |         |             |         |   | |
+-+ + +-+ + + + +-+ + + +-+-+-+-+-+-+-+-+-+-+-+-+-+-+-+-+-+-+ +-+ +-+-+-+ +-+ + +
|     |           |           |         |     | | | |   |               | | | | |
+-+-+ +-+-+ +-+-+-+-+-+-+-+-+ + +-+-+-+ +-+-+ + + + + +-+-+-+ +-+-+-+-+-+ + + + +
|         |     |       |   |   | | |       | | |   |         |         |     | |
+-+-+ +-+ + +-+ + +-+-+ + +-+-+ + + +-+-+-+ + + +-+ +-+-+-+ +-+-+-+ +-+ + +-+-+ +
|       | | | | |   | |     | |     | | | |         |           |   |     |     |
+-+-+ +-+ + + + +-+ + +-+-+ + + +-+ + + + +-+-+-+ +-+-+-+-+-+-+-+-+-+-+ +-+-+ +-+
|       | |   |   | | |     |   |   |       |     |     |         | |   |   |   |
+-+-+-+-+ +-+-+-+ + + +-+ +-+ +-+-+ + +-+-+ +-+-+ + +-+ + +-+-+-+ + + +-+-+ + +-+
|     | | | | |   |     |   | | | |   |   | | | |     |       | |       |       |
+-+ +-+ + + + + +-+-+-+ +-+ + + + + +-+-+ + + + + +-+-+-+-+-+ + +-+ +-+ +-+ +-+-+
|     |     |       |   |         |       |   |       |   |   |   |   | |     | |
+-+ +-+-+-+ +-+-+-+-+-+ +-+-+-+-+-+-+-+-+-+-+-+-+-+-+ +-+ +-+ + +-+-+-+ +-+-+ + +
|   | |     | |   |       | |   |   | |   | |         |       |       |         |
+-+ + +-+ +-+ + +-+ +-+-+ + +-+ +-+ + +-+ + +-+-+-+-+-+ +-+ +-+-+-+ +-+-+ +-+-+-+
|   |       | |   | |   | | |   | |         | | |         | |   |     | | | |   |
+ +-+-+ +-+ + + +-+ +-+ + + + +-+ +-+-+-+ +-+ + +-+-+ +-+-+ + +-+-+-+ + + + + +-+
|   |     |             |         |   | |   | |     |   |   |     | |         | |
+-+ +-+-+-+-+-+ +-+-+-+-+-+-+-+-+ + +-+ +-+ + +-+ +-+-+-+-+ +-+ +-+ +-+-+-+ +-+ +
|   |   |   |         |                     | | |       | | | |         |       |
+ +-+-+ +-+ +-+-+-+-+-+ +-+-+-+-+-+-+-+-+-+ + + +-+ +-+ + + + +-+-+ +-+ +-+-+ +-+
| |   |   | |                         |           |   | | | |     | |   |     | |
+ + +-+ +-+ +-+-+-+-+-+ +-+-+-+-+-+-+-+-+-+-+-+-+ +-+-+ + + + +-+ +-+-+ + +-+-+ +
|     |   |           | |   | |                     | |   | | |       |     |   |
+-+-+ +-+ + +-+-+-+-+ + +-+ + +-+-+-+-+-+-+-+-+ +-+ + + +-+ +-+-+-+ +-+-+-+ + +-+
| |     | |   |       |       |     | | |   | |   | |           | | | |       | |
+ +-+-+ + + +-+-+-+-+ + +-+-+ + +-+ + + +-+ + +-+-+-+-+ +-+-+-+ + + + +-+-+-+ + +
|       |   |   |     |     |     | |   |       |   |   |       |     |         |
+-+-+ +-+ +-+ +-+-+-+ + +-+-+-+-+-+ +-+ +-+-+-+ + +-+-+ +-+ +-+ +-+ +-+-+-+-+ +-+
| |     |           | |     | | |     | | | | | | |       |   |       |   |     |
+ + +-+ +-+-+-+-+-+ + + +-+-+ + + +-+ + + + + + + +-+-+-+-+-+-+-+ +-+ + +-+-+-+ +
| |   | | |     |   |   |     |     |   |     | | |         | |     | |   |     |
+ +-+ + + +-+-+ + +-+-+ +-+ +-+-+-+-+ +-+-+ +-+ + + +-+-+-+ + + +-+-+ +-+ + +-+-+
|     |           | |   |     |         | | |       | | |       |   | | |   |   |
+-+-+-+-+-+-+-+-+ + +-+ +-+-+ +-+-+-+ +-+ + + +-+-+ + + + +-+-+ +-+ + + + +-+-+ +
| | | |   | | |   |     |     |             | |   | | |     |       |   | |   | |
+ + + +-+ + + +-+-+-+-+ + +-+ +-+-+-+-+ +-+-+ + +-+ + +-+-+-+-+ +-+-+-+-+ +-+ + +
| | |           |     | |   | | | | |     |   |       |   |             |     | |
+ + + +-+-+-+-+ +-+-+ + +-+ + + + + +-+-+-+-+-+-+-+ +-+-+ +-+ +-+-+-+-+-+-+-+-+ +
| | |   | |   |   |   | | | | |             |               |           |       |
+ + +-+ + +-+ + +-+ +-+ + + + +-+-+ +-+-+ +-+-+-+-+-+-+-+-+ +-+-+-+ +-+-+ +-+-+-+
|   | |     | | |           |   |       | |           |   |   | |             | |
+-+ + + +-+ + + +-+-+-+ +-+-+-+ + +-+-+-+ + +-+-+-+-+ + +-+ +-+ +-+-+-+-+ +-+-+ +
|     |   |   |   |           |         |     | | |       | |   | | | | | | |   |
+-+-+ +-+ +-+-+-+ +-+-+-+-+ +-+-+-+-+-+-+-+-+ + + +-+-+ +-+ + +-+ + + + + + + +-+
| |     |   |   | | |             |     |   |   |     | |   | | | |   | |   |   |
+ +-+-+ + +-+-+ + + +-+-+-+-+-+-+ +-+ +-+ +-+-+ +-+ +-+-+ +-+ + + + +-+ + +-+ +-+
| |   |   |   | |             |       | |   |     | | |       | | | |   | |     |
+ +-+ + +-+ +-+ +-+-+-+-+-+-+ +-+-+-+ + +-+ +-+ +-+ + + +-+-+ + + + +-+ + +-+-+ +
|     | |   | |             | | |   | | |   | |   | | | |   | |   |           | |
+ +-+ + + +-+ +-+ +-+-+-+-+ + + + +-+ + +-+ + + +-+ + + + +-+ + +-+-+-+-+ +-+-+ +
| | | |   | |       |   |     |             | |       |   |   | | |   | |   |   |
+ + + +-+ + +-+ +-+ + +-+-+-+ +-+-+-+-+-+ +-+ +-+-+-+-+ +-+-+ + + +-+ + +-+ + +-+
| | | |     | |   | |   | |           |   |                 | |     |     |     |
+ + + +-+-+ + +-+-+ + +-+ +-+-+ +-+-+-+-+-+-+-+-+-+-+ +-+-+-+ +-+-+ + +-+ +-+ +-+
|   |     |     | | |   |       |     | | |     | | |     |   |     |   | | | | |
+ +-+-+-+ +-+-+ + + + +-+ +-+-+ +-+-+ + + +-+ +-+ + +-+ +-+-+-+-+ +-+ +-+ + + + +
|     |   | | | |     |   |         | |       |   | |   |   |     |   |   |   | |
+-+ +-+-+ + + +-+ +-+-+-+-+-+-+-+-+ + + +-+-+ +-+ + + +-+-+ +-+-+ +-+ +-+ + +-+ +
|   | | | | |   | | |     |     | | | |     |     |             | | | |   | | | |
+-+ + + + + + +-+ + + +-+ +-+-+ + + + +-+-+-+ +-+ +-+-+-+-+-+-+ + + + +-+ + + + +
|     | | | | |   | | |             | |         | | |     |   |   |   | | |   | |
+ +-+ + + + + +-+ + +-+-+-+-+ +-+-+ + + +-+-+-+-+ + +-+ +-+ +-+-+ + +-+ + + +-+ +
|   | | |             | | | |     |         | |         | | |   | | |   |   | | |
+ +-+ + +-+ +-+-+-+-+ + + + +-+-+-+ +-+-+-+ + +-+-+ +-+ + + + +-+-+ + +-+-+ + + +
|   |     | |       |             | | | | |     | | | |   | | | |   |     |   | |
+ +-+-+-+-+ +-+ +-+ +-+-+-+-+ +-+-+ + + + +-+-+ + + + + +-+ + + +-+ +-+-+ + +-+ +
| |   | | |       | | |   |     |   |       | |   |   |       |           |   | |
+ +-+ + + +-+-+ +-+ + + +-+-+ +-+-+ +-+ +-+ + +-+-+-+ +-+-+-+ +-+ +-+-+-+-+-+-+ +
|   |   | |       | |   |     | |         |   |           | | | |   |   | |   | |
+ +-+-+ + +-+ +-+-+ +-+ +-+ +-+ +-+-+-+-+-+-+-+-+-+-+ +-+ + + + + +-+ +-+ +-+ + +
|           |   | |   |   |   | |     |     |           | |   |       |         |
+ +-+-+-+-+-+-+ + +-+ +-+ + +-+ +-+ +-+-+ +-+-+-+-+-+-+-+-+-+ +-+-+-+ + +-+-+-+-+
| |   |   |         | | | |   | | |     |     |   |     |   |   |   | |         |
+ +-+ +-+ +-+ +-+-+-+ + + +-+ + + +-+-+ + +-+ +-+ + +-+ +-+ + +-+ +-+ +-+ +-+-+-+
|           | |             |               |     |   |                         |
+-+-+-+-+-+-+-+-+-+-+-+-+-+-+-+-+-+-+-+-+-+-+-+-+-+-+-+-+-+-+-+-+-+-+-+-+-+-+-+-+