+-+-+-+-+-+-+-+-+-+-+-+-+-+-+-+-+-+-+-+-+-+-+-+-+-+-+-+-+-+-+-+-+-+-+-+-+-+-+-+-+-+-+-+-+-+-+-+-+-+-+-+-+-+-+-+-+-+-+-+-+-+-+-+-+-+-+-+-+-+-+-+-+-+-+-+-+-+-+-+-+-+-+-+-+-+-+-+-+-+-+
| | | |       | | |   |   |     | | |   |     |     |   |       |         |     |   | |       |     | |             |       |   |             | | |   |         | | |   | |         |
+ + + + +-+-+ + + +-+ +-+ + +-+ + + + +-+-+-+ +-+ +-+ +-+-+ +-+ + +-+-+-+-+ +-+ +-+ + + +-+-+ + +-+ + +-+ +-+-+-+-+ +-+-+-+ +-+ +-+ +-+-+ +-+ + + +-+ + +-+-+-+ + + +-+ + +-+-+-+ +-+
|           | |   |           |             | |     | | |     |         |   | |         |     | |     | |         | | |     |   | |     | | | |       |   | |     |     |   | | | | |
+ +-+-+-+-+-+ + +-+-+-+-+-+ +-+-+-+-+-+-+-+ + +-+ +-+ + +-+ +-+-+-+-+-+ +-+ + +-+-+ +-+-+-+ +-+-+ +-+ + + +-+-+-+-+ + +-+-+ +-+ + + +-+-+ + + +-+-+ +-+-+ + +-+-+ + +-+ + +-+ + + + +
|   |     | |   |   | |   | |       |     | | |             |         |   |     |     |   |       |   |           |       | | |       | |   | |     |   | |   |   | |           |   |
+ +-+-+ +-+ + +-+ +-+ +-+ + +-+ +-+ +-+ +-+ + + +-+-+-+-+-+ + +-+-+-+ +-+ + +-+-+-+-+ +-+ +-+-+ +-+-+ + +-+-+-+-+-+-+-+-+ + + + +-+-+ + +-+-+ + +-+ + +-+ + +-+ +-+-+-+ +-+-+-+ + +-+
| | |           |       |   |     |       |   | |   | | | |     | |     | |     |   | | | | |       | |     |       |   |     | | |         |     |   |     |   |     | | |     | | |
+ + +-+-+-+ +-+ +-+-+ +-+-+ + +-+-+-+ +-+ + +-+ + +-+ + + +-+ +-+ +-+-+ + +-+ +-+ +-+ + + + +-+-+ +-+ +-+-+ +-+-+ +-+ +-+-+-+ + + +-+-+-+-+ +-+-+-+-+ +-+-+-+ +-+-+ +-+ + +-+ +-+ + +
|   |   |     |       | | |   |       | | | |     |   |     | | | | |   | |   |         |   | | |   |   | |     |             |   | | |   |     | | |   |                 |     | | |
+-+ +-+ +-+-+-+ +-+-+ + + + +-+-+-+-+ + + + + +-+-+ +-+-+-+ + + + + +-+-+ +-+-+-+ +-+-+ +-+ + + + +-+-+ + +-+-+-+ +-+-+-+-+-+ + +-+ + + +-+-+ +-+ + + +-+-+-+-+ +-+-+-+-+ +-+-+ + + +
|   | |   |       |     | | |     | | | | |       |           |       |   | |         |     | |   |   | |         | |       | |       |       |     |   |   |   |           | |     |
+ +-+ +-+ +-+-+-+-+-+-+ + + +-+ +-+ + + +-+-+-+-+-+-+-+-+-+-+ + +-+-+ +-+ + +-+-+-+-+-+ +-+ + +-+ +-+ + +-+-+-+ +-+ +-+-+ +-+ + +-+-+ +-+-+-+ + +-+ + +-+-+ +-+-+-+-+-+ +-+ + +-+-+ +
| |       |         |   | | |       |   |           |     |   | |       |         | |     |   |     | |   | | |       |         |       | |   |   |     |       |         |   |   | |
+ + +-+-+ +-+-+-+-+ + +-+ + +-+ +-+ +-+ +-+-+-+ +-+ +-+ +-+-+ +-+-+ +-+-+-+-+ +-+ + +-+-+-+-+-+ +-+ + +-+ + + +-+-+-+-+ +-+-+ +-+-+-+-+ + +-+-+-+-+ +-+ +-+-+ +-+-+-+-+-+-+ +-+-+ + +
|   |   | |       |     |     | |   | |     | | |     |           |   | | |   |   |     | |   | | | | | | |       | |     | |   | |               | |     |     | |               | |
+ +-+ +-+ +-+ +-+-+-+ +-+-+-+ +-+ +-+ + +-+ + + +-+-+-+-+-+-+ +-+ + +-+ + +-+-+ +-+ +-+ + + +-+ + + + + + + +-+-+ + + +-+ + + +-+ +-+-+-+-+-+-+-+-+ +-+ +-+ +-+ + + +-+-+-+-+-+-+-+-+
|   |       |       |     | | | | |   |   | | | | | |     |     |   |       |     | |   | | | |   | | |     | | |     |     |   | |             |     |       | | |           | | | |
+-+ +-+-+-+ +-+-+ +-+-+-+ + + + + +-+ +-+ + + + + + + +-+ +-+-+ +-+-+ +-+-+ +-+-+ +-+ +-+ + + + +-+ + +-+ +-+ + + +-+-+ +-+-+ +-+ + +-+-+ +-+-+ +-+-+-+-+-+-+-+ + +-+-+-+-+ +-+ + + +
| |       |   | |       |   | |   | |     | |         |   | |           |   | |     |   | |       | | | | | | | | | | |   |     |   |       | | |       |   |   |         |       | |
+ +-+ +-+-+-+ + + +-+-+ + +-+ +-+ + +-+-+ + +-+-+ +-+-+-+ + +-+ +-+-+-+-+-+ + +-+ +-+ +-+ +-+ +-+-+ + + + + + + + + + + +-+-+-+ +-+-+ +-+-+ + + +-+-+-+ +-+ + +-+-+-+ +-+ +-+-+ +-+ +
|     |     |   |     | | |   | |   |     |     | |   |   | |       |           |     |   |     |     |   |       |       | |   |       | |   | |     |   | |   | |   |   |   |     |
+ +-+ +-+-+ + +-+-+-+-+ + + +-+ +-+ +-+-+ +-+-+ + + +-+-+ + +-+-+-+-+-+-+-+ +-+-+-+-+ +-+ +-+ +-+-+-+-+-+-+-+-+-+-+-+-+-+ + + +-+-+ +-+ + + +-+ +-+ +-+ +-+ +-+ + + +-+-+ +-+ +-+-+ +
|   |     | |   |         | |                 |   |       |   | | |   | |   |   |   | |   |     | | | |             |       |     |   | | | | |     |     | | | |     | | |         |
+ +-+-+-+ + +-+-+-+-+ +-+ +-+-+-+-+-+-+-+-+-+ +-+-+-+-+-+ +-+ + + +-+ + +-+ +-+ +-+ + + +-+-+-+ + + + + +-+-+-+-+-+-+-+-+-+ +-+ +-+-+-+ + + + +-+-+ +-+ +-+ + + + +-+ + + +-+-+ +-+-+
|   | |       |     | |     | |     | |       | | | | | |           | |             |         |   | | | |   | | |     |     | |   |   |   |       |       |   |   | | | | |   |   | |
+-+ + +-+ +-+ +-+ +-+-+-+ +-+ + +-+ + +-+ +-+ + + + + + +-+-+ +-+-+ + +-+-+-+-+-+-+ +-+-+-+-+ + +-+ + + + +-+ + +-+ +-+-+ +-+ +-+ +-+ +-+-+-+-+-+-+-+-+-+ +-+ + +-+ + + + + +-+ +-+ +
| |   | | |   | |   |             | | | | |   |   |     |     |   |         | |       |   |     | |     |   | | |     |         | |         |   |     | |     |   | | | |           |
+ +-+ + + +-+ + + +-+ +-+-+-+-+-+-+ + + +-+-+ + +-+-+ +-+-+ +-+-+ +-+-+-+ +-+ +-+ +-+ +-+ +-+ +-+ + +-+ +-+ + + +-+-+ +-+ +-+-+-+ +-+-+-+-+ +-+ +-+-+ + + +-+ +-+ + + + +-+-+-+-+ +-+
|   |   |   | | |   | | | | |       |   | | | |       |     |           |     |     |       |   |   |     |     | |             |             |         | |     | |       | | |     |
+ +-+-+-+-+-+ + +-+ + + + + +-+ +-+ + +-+ + + + +-+-+ + +-+ +-+-+-+-+-+ +-+-+-+-+-+-+-+-+-+-+-+ + +-+-+-+ +-+-+ + +-+ +-+-+-+-+-+-+-+-+-+-+-+-+-+ +-+-+ +-+-+ +-+-+ +-+-+ + + +-+ +-+
| | |   | |     |       | |       |               |   | |     |   |       |             |   | | | | |         |   |           |       |       |     |   |   | |   | |         |   | |
+ + + +-+ +-+-+-+-+ +-+ + +-+-+-+-+ +-+-+-+-+-+-+-+-+-+-+-+-+ +-+ +-+ +-+ +-+-+-+-+-+-+ + +-+ + + + +-+-+-+ +-+ +-+ +-+-+-+-+ +-+-+ +-+-+ +-+ + +-+-+-+ + +-+ + +-+-+-+ +-+-+-+-+-+ +
|   | |       | | |   | | | |         | |   |       | | | |   |     |   |     |               | |     |         | |     | | |   | |   |   | | |   | |       | | | |   | |           |
+ +-+ + +-+-+ + + +-+-+ + + + +-+-+-+ + +-+ +-+-+ +-+ + + +-+ + +-+ +-+-+-+-+ +-+-+-+-+-+-+-+ + + +-+-+ +-+-+-+ + +-+ +-+ + +-+ + +-+ +-+ + + + +-+ +-+-+-+ + + + + +-+ +-+ +-+-+-+-+
|   |   | | | | |           | |     |           |       | | |     | | |   |   |   |       |   |     | | |           |     |   | | | |       |   |     |       |   |     | |         |
+-+ + +-+ + + + +-+-+-+-+-+ + +-+-+ +-+-+ +-+-+-+-+-+-+ + + + +-+-+ + + +-+-+ + +-+-+-+ +-+ +-+-+ +-+ +-+-+-+ +-+ +-+-+-+ +-+ + + + +-+ +-+-+-+ +-+-+ +-+-+ +-+-+ + +-+ + +-+-+-+-+ +
|   |       |       |       | | | | | |               | |     | |       |             |       | |           | | |   |   | |           |     | |       |       |       |   |   |     |
+ +-+-+-+-+-+-+ +-+-+-+-+-+ + + + + + + +-+-+-+-+-+-+ + +-+ +-+ +-+-+-+ +-+-+-+-+-+-+ +-+-+-+ + +-+ +-+-+-+-+ + +-+ + +-+-+-+-+-+-+ +-+-+ +-+ + +-+-+-+-+-+-+ +-+-+-+ +-+-+ +-+ +-+-+
| | |   |   |   |     |     |         | | |     | | | |   |   |     |   | |       |     | | | |             | |     |   | | |               |     | |   |   |       | | | | | | | | |
+ + + +-+-+ + +-+-+-+ +-+ +-+-+-+-+-+-+ + + +-+ + + + + +-+ +-+ +-+ + +-+ +-+-+ +-+-+ +-+ + + +-+-+-+-+-+-+ +-+-+-+ +-+ + + + +-+-+-+-+-+ +-+-+-+ + +-+ + +-+-+-+-+ + + + + + + + + +
|       | | | | |         | |       | |   | |   | | | | | | |     |   | |   |   | | |   |   |   |     |     | |           | |           |   |   |   |   |     |     |   | |         |
+ +-+-+ + + + + + +-+-+-+ + +-+ +-+ + + +-+-+-+ + + + + + +-+-+-+ +-+ + +-+ + +-+ + +-+ +-+ +-+ +-+-+ +-+-+ + +-+-+ +-+-+ + +-+-+ +-+-+-+-+ + +-+ +-+-+ + +-+ +-+-+ +-+ + +-+-+ +-+-+
|     | |   |     |     | | | |   |                 | |   | | |     | | |               |       |         |     | | |         |   |   | |       |           |     |   | |     | |   |
+-+-+ +-+-+ +-+ +-+-+ +-+ + + +-+ +-+-+-+-+-+-+-+-+-+ + +-+ + + +-+-+ + +-+ +-+-+-+-+-+-+-+-+ +-+ +-+-+-+ +-+-+ + +-+-+-+-+-+-+-+ +-+ + +-+-+-+-+-+-+-+-+-+-+-+-+-+-+-+ +-+-+ + + +-+
| |               |     | |       |     |   | |           |       |   |   | | |     | |     | |   | | | | |     |   | | |       | |   |   |   |             | | |     |             |
+ +-+-+-+ +-+-+-+ + +-+ +-+ +-+-+ + +-+ + +-+ +-+-+-+-+ +-+-+-+-+-+-+-+-+ + + +-+ +-+ +-+ +-+ +-+ + + + + +-+ +-+-+ + + +-+ +-+ + +-+ + +-+ +-+-+-+-+-+-+ +-+ + +-+ +-+-+ +-+-+-+-+-+
|     | |       | |   |   |   | |     |       |         |     |   |       |         |   |   |           | | | |   |   | |     |   |   | |     |     | | | | | | |       | |   |   | |
+-+-+ + + +-+-+-+ +-+-+-+ + +-+ +-+-+-+-+-+-+-+-+-+-+ +-+ +-+ + +-+-+-+-+ +-+ +-+-+ +-+ + +-+-+-+-+-+-+ + + + + +-+ +-+ +-+-+-+-+ + +-+ +-+-+ +-+ +-+ + + + + + + +-+-+ + + +-+-+ + +
|         |           |           |   | |         | | |     | |   |               | |   |   |         | | |   | | |   |       |       |     |     |   | |       |   |   |     |     |
+ +-+-+-+-+-+-+-+-+-+-+-+-+-+-+-+-+ +-+ +-+-+-+-+ + + +-+-+ + + +-+-+-+ +-+-+-+-+-+ + +-+ +-+-+ +-+-+ + + +-+ + + +-+ +-+-+ +-+-+-+-+ +-+-+ +-+-+ +-+ + +-+-+-+ +-+ +-+ + +-+ + +-+-+
|       |             |         | | |       |   |   | | | | |     |           | | |           | | | | | |       | | | |         |         |       | |                 |   |   |     |
+-+-+ +-+-+ +-+-+-+-+-+-+-+-+-+ + + +-+-+ +-+ +-+-+ + + + +-+ +-+ +-+-+-+ +-+ + + +-+-+ +-+-+ + + + + +-+-+-+-+ + + + +-+-+ +-+ +-+-+-+-+ +-+-+ +-+ +-+-+-+ +-+-+-+-+-+-+-+-+ +-+ +-+
|   | |   |       |   |   | |   | |   |   |       | |     | | |     |   |   | | |         |         |       |   |   | |       |   |   |     |   | | |     |   |   |     |   |       |
+-+ + + +-+-+ +-+ +-+ + +-+ +-+ + + +-+-+ + +-+-+ + + +-+ + + +-+-+ +-+ + +-+ + +-+-+-+-+-+-+-+ +-+-+-+-+-+ +-+ +-+ + +-+-+-+-+ +-+ +-+-+ +-+ +-+ + + +-+ +-+ +-+ +-+ +-+-+ + +-+-+-+
|     |     |   |     |               | |       | |     | | |     | | | |   | |     |   |                 |     | | |   |       | |   |   | | |   |   |         |   |   |     |     |
+ +-+ +-+ +-+-+ +-+-+ +-+ +-+-+-+-+-+ + +-+-+-+ + + +-+-+ + +-+-+-+ + + +-+-+ +-+-+ +-+ +-+-+-+-+-+-+ +-+-+-+-+ + + + +-+ +-+-+ + + +-+ +-+ + + +-+-+-+-+ +-+-+ +-+ +-+ +-+-+ + +-+-+
|   | |       |     |         |           |     |       |     |     | |   | | | |     | |   |   | |   | |     |   |   |       | | |   |   | | |   | | |       | |     |         |   |
+-+-+ +-+-+ +-+-+-+-+ +-+-+-+-+-+-+-+-+-+ +-+ +-+-+-+-+-+-+-+ + +-+ + + +-+ + + +-+-+ + +-+ +-+ + +-+ + + +-+ + +-+-+ +-+-+-+-+ + +-+ + +-+ + + +-+ + +-+ +-+-+ +-+-+ +-+-+ +-+ + +-+
|   |         |     | |         | |     | |     | | |             |   |     | | |   | |   |   | | |       |   | | |   |           | | | | | | |     |   | | | |   |       |   |     |
+-+ +-+-+ +-+ +-+ +-+ +-+-+-+ +-+ +-+-+ + +-+-+ + + +-+ +-+-+-+-+-+-+ + +-+ + + +-+ + + +-+ +-+ + +-+-+ +-+-+-+ + + +-+-+-+-+ +-+ + + + + + + +-+-+ + +-+ + + +-+ +-+-+-+ +-+-+ +-+ +
|   |     | |         | |       | |         |         | |         |   | |   |     |   |       |         | | | |   |     |   | |     |   |   |             | |   | | | |   |   |   | |
+-+ +-+-+ + +-+-+ +-+ + +-+-+ +-+ + +-+-+-+-+-+-+-+-+-+ +-+-+ +-+ + +-+-+ +-+-+-+ +-+ +-+-+-+ +-+-+ +-+ + + + + +-+ +-+ +-+ +-+ +-+ +-+ +-+ +-+-+-+-+-+ +-+ + +-+ + + +-+ +-+ + +-+-+
|   | | | | |       |     |     |       |   | |         |       |       |       | |     |     |   |   |   | | |       |   |     |     |   |                 |   | | |   |       | | |
+ +-+ + + + +-+-+-+ +-+-+ + +-+ + +-+-+ + +-+ +-+-+-+-+-+-+-+-+-+-+ +-+ + +-+-+ + +-+-+ + +-+-+-+ +-+ +-+ + + +-+-+ +-+-+ + +-+-+-+-+ +-+-+-+-+-+-+-+-+-+-+ +-+ + + +-+ +-+ +-+ + + +
| |               |     | |   |   |                 |           |   |       |   |   | |     | |     |   | |   |   |   | |           |     | |     | |   |   |   | |   | |     |     |
+ +-+ +-+-+-+-+-+-+-+-+ +-+-+-+-+-+-+-+-+-+-+-+-+-+ +-+-+-+-+-+ +-+-+-+-+-+-+-+ +-+ + +-+ +-+ +-+ +-+-+ + + +-+-+ +-+ + +-+-+-+-+ +-+-+-+ + +-+ +-+ + +-+ +-+ +-+ + +-+ +-+-+-+-+-+ +
| | |     |   |   |       |     |   | |         |       | |             | | |     |   | | |     | |     |         |     | |             |     |     |           |   | |   |       | |
+ + +-+ +-+-+ +-+ +-+-+ +-+-+-+ + +-+ +-+-+ +-+ +-+ +-+ + +-+-+-+-+-+ +-+ + +-+ +-+-+ + + +-+-+ + +-+-+-+-+-+-+ +-+-+-+ + +-+-+-+ +-+-+-+-+-+ +-+-+ +-+-+-+-+-+ +-+ + +-+ +-+-+ +-+ +
|       |         | |   | |     |       | |   | | |   |   | | |       | |         |                 | |       |       | |   |               | |     |         |   | |   | | |   |   |
+-+ +-+ +-+-+-+ +-+ +-+ + +-+-+ + +-+-+ + + +-+ + +-+-+-+ + + + +-+-+ + +-+-+-+ +-+-+-+-+-+ +-+-+-+ + +-+-+-+ +-+-+-+-+ +-+ +-+ +-+-+-+-+-+-+ +-+-+ +-+ +-+-+ + +-+ + +-+ + + +-+ +-+
|   | | | |           | | | |     |   |     | |     |               |   |   | |     | | |   |   |   | |   |       |         |             | | |   |   |   |     |   |   |     | |   |
+-+ + + + +-+-+-+-+-+ + + + +-+-+ +-+ +-+-+ + +-+-+ +-+-+-+-+-+-+-+-+ +-+ +-+ +-+-+ + + +-+ + +-+ +-+ + +-+ +-+-+ +-+-+-+-+-+-+-+-+-+-+-+ + + + +-+ +-+ +-+-+-+ +-+ +-+ + +-+ + +-+ +
| | | |       | |     |     | |     |           | | |     | |   |   | |   | | | |     |       | |   |     |     | |     | | |   |   |       | |     | | | |       | | |   |     | | |
+ + + + +-+-+ + +-+-+ + +-+ + +-+-+ +-+-+-+-+-+ + + +-+ +-+ + +-+-+ + +-+ + + + + +-+-+-+-+-+ + + +-+-+-+ +-+-+-+ + +-+ + + +-+ + +-+-+-+-+-+ +-+ +-+ + + +-+-+ +-+ + +-+-+-+ +-+ + +
|     | |       | | |     |   |     | |     |   |       |         | |   |   | |   |   |       | | | |           |     | |     |   | |   | | | | |       | |       |       |       | |
+-+-+-+-+-+ +-+-+ + + +-+-+-+ +-+ +-+ + +-+-+-+-+-+-+ +-+-+-+-+-+ + + +-+-+ + +-+ + +-+ +-+-+ + + + +-+ +-+ +-+ +-+-+ +-+ +-+ + +-+ +-+ + + + + +-+-+-+ + + +-+-+ +-+-+-+ +-+-+-+ + +
|     |         |   |   |           | |   |   | | |             |           |     |   |     | |   |   | | | | |             | | | |     |   | |         | |   | |       |         | |
+-+-+ + +-+-+-+ + +-+-+-+-+-+-+ +-+ + + +-+-+ + + +-+-+-+ +-+-+-+-+-+-+-+-+-+-+-+ + +-+-+ +-+-+-+ + +-+ + + + +-+-+-+-+-+-+-+ + + + +-+ +-+ +-+-+-+-+-+ + +-+ + +-+ +-+-+-+-+-+-+-+-+
|   |   | |   | |   | |     | |   |   |     |   | |                             | | |   |   |     | |   |   |               |   |     | | |   | |   |       |   | |   |     |       |
+-+ +-+ + +-+ + +-+ + + +-+ + +-+-+-+ +-+-+ +-+ + +-+-+-+-+-+-+-+-+-+-+-+-+-+-+ + + +-+ +-+ +-+-+ + + +-+-+-+-+-+-+-+-+-+ +-+ +-+-+-+ + + + +-+ +-+ +-+-+ +-+-+ + +-+ +-+-+ +-+-+ +-+
|     | |         |   |   |   | | | | |         |   |   |       |           |   |   |     |   | |   |     | | |   |     |   |         |           |         | | |   |   | | | |   | |
+-+ +-+ +-+-+-+-+ + +-+ +-+-+ + + + + + +-+-+-+ + +-+-+ + +-+-+ +-+-+-+ +-+ +-+-+-+ + +-+ + +-+ + +-+-+ +-+ + + +-+ +-+ + +-+ +-+-+-+-+-+-+-+-+ +-+-+ +-+-+ + + +-+ + +-+ + + + +-+ +
|   |     |     | | |   | | | | | |       | | |   |     |   |     |       |   | | | |   |   | |             |   | | | |   | |                 | | |       |   |     |             | |
+ +-+-+-+ +-+-+ + + + +-+ + + + + +-+-+-+ + + +-+ + +-+ +-+-+-+-+ +-+ +-+-+-+ + + + +-+-+-+ + +-+-+-+-+ +-+ + +-+ + + +-+ + +-+-+-+-+-+-+-+-+ + + +-+-+-+-+-+ +-+-+-+-+ +-+-+-+-+-+ +
|   |     | |       | |         |   |       |   |     | |   |   |   |   | |           | | |     |   | | | |   |     | | |   |     |   | |     |         | |     | | | |   |     |   |
+-+ +-+-+ + +-+-+ +-+-+ +-+-+-+ +-+ +-+ +-+-+-+ +-+-+-+ +-+ + +-+-+ +-+ + + +-+-+-+-+ + + +-+ +-+-+ + + + + +-+ +-+ + + +-+ +-+-+ +-+ + +-+-+-+-+-+-+-+ + +-+-+ + + + +-+ + +-+ +-+ +
| |     |     |     | |   |     | | |   | | |             |   | | |       | | | |   |     |     | |   |   | |   | |   | | | | |       |     | |     |         | |       | |   |   | |
+ +-+-+ +-+-+-+-+-+ + +-+ +-+ +-+ + + +-+ + + +-+-+-+-+-+-+-+ + + +-+-+ +-+ + + +-+ +-+ +-+-+-+-+ + +-+-+-+ +-+ + +-+ + + + + +-+-+ +-+-+-+ + + +-+-+-+-+-+ +-+ +-+-+ +-+ +-+-+ +-+ +
| | | |         |     |     | |             |   | | | | |             | |       | |   |       |   |     | | |       | |   |     |     |       |           |   | | | | |   |   | | | |
+ + + +-+ +-+-+ + +-+-+ +-+-+ +-+-+-+-+-+ +-+-+ + + + + +-+-+-+-+-+-+ + +-+-+-+ + + +-+-+-+ +-+-+ + +-+ + + +-+-+-+ + + +-+-+ +-+-+ +-+-+-+ +-+-+ +-+-+-+ + +-+ + + + + +-+ +-+ + + +
| | | | | | |         |     |     | |     |     |         |         | | |   |         |     |       |               |   |   |   |             |     |   |   |         | |   | |   | |
+ + + + + + +-+-+-+-+ +-+-+-+ +-+ + +-+-+-+-+ +-+-+ +-+-+ +-+-+-+-+ + + + +-+-+-+-+-+-+-+-+-+ +-+-+ +-+-+-+-+-+-+-+-+-+ + +-+-+ +-+-+-+-+ +-+ +-+ +-+ +-+ +-+-+-+-+-+-+ + +-+ +-+ + +
|   |         |       | |       |   | |     | |   |     | |       | |     |   |         | |   |       | |   |   | |           |       |     |     | |   | |   |               |   | |
+-+ + +-+-+-+-+-+-+-+ + +-+-+-+-+ +-+ + +-+ + +-+ +-+-+ + +-+-+-+ + +-+-+ +-+ +-+-+-+ +-+ +-+ +-+-+-+ + + +-+-+ + + +-+-+-+-+-+-+ +-+-+ +-+-+-+-+ + + +-+ + +-+-+-+ +-+-+-+-+ + +-+ +
|   |         | | |   |     |   | |   |   |     |   | | |   | | |     |   |       | |             |           |   |   |       |       |     | |   |       |       |   | |   | |     |
+-+ +-+-+ +-+ + + + +-+-+-+ + +-+ +-+ + +-+-+-+ + +-+ +-+ +-+ + + +-+ + +-+-+ +-+ + +-+-+-+-+-+-+-+-+-+ +-+-+ + +-+ +-+ +-+-+ +-+-+-+ +-+-+ + + +-+-+-+-+ + +-+-+ +-+ + + +-+ +-+ +-+
|           | |     |   |   |   |         | |     | | | |       | | |         |       | | | |   |   | | |         | |       | |     |     |   |   | |         |     |       |     | |
+-+-+-+-+-+-+-+-+-+ + +-+-+ +-+ +-+-+-+ +-+ +-+-+ + + + +-+-+-+ + + +-+ +-+-+-+-+-+-+ + + + +-+ + +-+ +-+-+-+-+ +-+ +-+-+ +-+ + +-+ +-+-+-+-+-+ +-+ +-+-+-+-+-+-+-+-+-+-+-+-+ +-+-+ +
|   |     |     | |   | | |       |     | |   | | |       |   |       |       |     | | | | |       | | | |   | | |         | | |       |     |                       |   |         |
+ +-+-+ +-+-+ +-+ +-+ + + +-+-+ +-+-+ +-+ +-+ + + +-+ +-+ + +-+-+-+-+-+-+ +-+ +-+-+ + + + + +-+-+-+ + + + + +-+ + +-+-+ +-+-+ +-+ +-+ +-+-+ +-+-+-+ +-+-+-+-+-+-+-+-+ +-+ +-+ +-+-+-+
| |   |     | |         |         |       |     | |   | | |   |       |     |   | |     | |             | |       | | |   |       |       | |           |   |   |           |       |
+ +-+ +-+ +-+ + +-+-+-+ +-+-+-+ +-+-+-+-+ +-+-+ + +-+ + + + +-+-+-+-+ +-+-+-+-+ + +-+-+ + + +-+-+-+-+-+ + + +-+-+ + + +-+ +-+-+-+-+-+-+-+ + +-+ +-+-+-+ +-+ + +-+-+ +-+-+-+-+-+-+-+-+
|     |         |     | |             | |       |       |     | | |     |     |   | |         |         | |   |         | |       | | |   |       | |             | | |     | |     |
+-+-+ +-+-+-+ +-+-+ +-+ +-+-+ +-+-+-+ + +-+-+-+-+-+-+ +-+-+-+ + + +-+-+ +-+ +-+-+ + +-+-+-+-+ +-+-+-+-+ + +-+-+-+-+-+ +-+ + +-+-+ + + +-+-+-+ +-+ + +-+-+-+-+-+-+ + + +-+-+ + +-+ +-+
|       | |     |     |           |   |     |   |       |     | | | | | |       | |             | |   |     | | |     | | | | |       | |       |         |     | | |           | | |
+-+-+-+ + +-+-+ +-+ +-+-+-+-+-+ +-+-+ + +-+-+ +-+-+-+-+-+ +-+ + + + + + + +-+-+ +-+-+-+-+-+-+-+ + +-+ +-+-+ + + +-+-+ + + + + +-+-+ +-+ +-+-+-+-+-+-+-+ +-+-+-+ +-+ +-+-+-+-+ +-+ + +
| |   | | |       |       |         |         |     |       | | |     | |     |       | | | |     |       |     | | | |   |       |       | | | | |     |     |     | | |     | |   |
+ + +-+ + +-+ +-+ + +-+-+ +-+-+-+-+ +-+-+-+-+ + +-+ + +-+-+-+ + +-+-+ + +-+-+-+ +-+-+ + + + +-+-+ +-+ +-+ +-+-+ + + +-+-+ +-+-+-+ +-+-+-+ + + + + +-+ +-+-+ +-+ +-+ + + +-+ +-+ +-+ +
|       | |   |       |   | |   |     | | | | | |     |     | |     |   |   |   |   |   |   |           |     |       |   | | |   |           | |       |   |     |                 |
+-+-+ +-+ +-+-+-+ +-+-+-+ + +-+ + +-+ + + + +-+-+-+ +-+-+-+ + +-+-+ +-+ + +-+-+ +-+ +-+ + +-+-+-+-+-+-+-+ +-+-+-+-+-+-+-+ + + + +-+-+-+-+-+-+ + + +-+-+ +-+ +-+-+-+-+ +-+-+-+-+-+-+-+
|   | | | |   | | | |   |       |   | |     |       |       |   | |   |     | |   | |     |   |           |           |   | | | | | |       | | | |       |             |   |     | |
+ +-+ + + +-+ + + + +-+ + +-+-+-+-+-+ +-+ +-+ +-+-+ +-+ +-+ +-+ + +-+ +-+ +-+ +-+ + +-+ +-+ +-+-+ +-+-+-+ +-+-+-+-+ +-+-+ + + + + + + +-+-+ + + +-+ +-+-+-+-+-+-+-+-+-+ +-+ +-+ +-+ +
|           |           | | |           |   |     | | |   | |     |     |     | | | |       | |         |     | |   | |   | | | |   |     |       |       |   | | |     | |     |   |
+-+ +-+-+-+ +-+-+-+-+ +-+ + + +-+ +-+-+ + +-+-+-+-+ + + +-+ +-+-+ +-+ +-+-+ +-+ + + + +-+-+ + +-+-+-+-+ +-+-+ + +-+ + + +-+ + + + +-+-+-+ +-+-+-+-+-+-+-+ + +-+ + +-+ +-+ + +-+ + +-+
|       | |     |       | |   |       |           |     |       | | |       |   |   |   | |     |           |   |   | |     |     | |   | | |         |           |   | | |   |     |
+-+-+-+ + + +-+ +-+-+-+-+-+-+-+-+-+-+ +-+-+-+-+-+-+-+-+-+-+ +-+-+ + + +-+-+ + +-+-+ +-+ + +-+-+ +-+-+-+-+-+ +-+ +-+ + + +-+ +-+-+ + + +-+ + + +-+-+-+ +-+-+-+-+-+ +-+ + + + +-+-+-+-+
|     | | | |       |     | |     |   | |   | | |       |     |     |     |       | |   |       |       | | |     |       |   |     |       | | | | | |       |     | |           | |
+-+ +-+ + +-+-+ +-+ + +-+ + +-+ +-+ +-+ +-+ + + +-+-+-+ +-+-+ +-+-+ +-+-+-+-+ +-+ +-+-+-+-+ +-+ +-+-+ +-+ +-+ +-+-+-+-+-+-+-+ +-+-+-+ +-+-+ + + + + + +-+-+-+ + +-+-+ +-+-+-+-+ +-+ +
|             |   |     |                                 |       |           |               |             |               |           |     |             |     |                 |
+-+-+-+-+-+-+-+-+-+-+-+-+-+-+-+-+-+-+-+-+-+-+-+-+-+-+-+-+-+-+-+-+-+-+-+-+-+-+-+-+-+-+-+-+-+-+-+-+-+-+-+-+-+-+-+-+-+-+-+-+-+-+-+-+-+-+-+-+-+-+-+-+-+-+-+-+-+-+-+-+-+-+-+-+-+-+-+-+-+-+