+-+-+-+-+-+-+-+-+-+-+-+-+-+-+-+-+-+-+-+-+-+-+-+-+-+-+-+-+-+-+-+-+-+-+-+-+-+-+-+-+-+-+-+-+-+-+-+-+-+-+-+-+-+-+-+-+-+-+-+-+
|         | | |   |   |   |       | |         | |   | | |           |       | | |     |     |   | | | | | |   |     |   |
+-+-+-+-+ + + +-+ +-+ + +-+ +-+-+ + +-+-+ +-+ + +-+ + + +-+-+-+ +-+ + +-+-+ + + +-+-+ +-+-+ +-+ + + + + + + +-+-+-+ +-+ +
|     | | | | | | | | |   |     |   |       |               |     |   |   |   |       | |   |   | |       |   |       | |
+ +-+ + + + + + + + + +-+ +-+-+-+-+ +-+-+ +-+ +-+-+-+-+-+-+ +-+-+-+-+ +-+ +-+ +-+-+-+ + +-+ + +-+ + +-+ +-+ +-+ +-+-+-+ +
|   | |     |     | | | |   |       |       | | | |     | | |               |     | |   |     |       | |     |         |
+ +-+ +-+ +-+-+-+ + + + + +-+-+ +-+ + +-+-+-+ + + +-+-+ + + +-+-+ +-+ +-+-+-+-+-+ + +-+ + +-+ +-+-+-+ +-+ +-+ +-+-+ +-+-+
| |           |     | |     |   |   |     |       | |   | |         | | |           | |     | |   | |   |   | | |     | |
+-+ +-+-+-+-+ +-+ +-+ +-+-+ + +-+-+ +-+-+ + +-+-+ + + +-+ +-+-+-+-+ + + +-+-+ +-+-+ + +-+-+ + + +-+ + +-+-+-+ + + +-+ + +
|     |   | |     |   | | | |     | |     | | |   |   |     | | | | |   | | |   |   | | |   |   | | |     |   | |   | | |
+-+-+ +-+ + +-+ +-+ +-+ + + +-+-+ +-+-+-+ + + +-+ + +-+-+-+ + + + +-+-+ + + + +-+-+ + + + +-+-+ + + +-+ +-+ +-+ + +-+-+ +
|   |     |           | | |       | |   | | | | | |   |         |       | |   |   |     | | |           |     | |   |   |
+ +-+-+-+-+-+ +-+-+-+-+ + + +-+-+ + + +-+ + + + + + +-+-+-+-+-+ +-+-+-+ + +-+ + +-+ +-+ + + +-+-+-+-+-+ + +-+ + + +-+ +-+
|     |     |   | |   | | | | | |         | |     |   | |     |         | | |   |     | | |     |   | |     |       |   |
+-+-+ +-+ +-+-+ + +-+ + + + + + +-+-+-+-+ +-+-+-+ +-+ + +-+ +-+ +-+-+-+ + + +-+-+-+-+ + + +-+ +-+ +-+ +-+-+-+ +-+-+ + +-+
|       | | | |     | | |   | | | |       | | |               |   | |     | |     |   | | |         |   |     |       | |
+-+-+-+ + + + + +-+ + + +-+ + + + +-+ +-+ + + +-+-+-+-+-+ +-+-+-+ + + +-+ + +-+ +-+-+ + + + +-+-+-+ +-+ +-+ +-+-+-+-+-+ +
|   |       |     | | |   | |     |     | |       | |       |   | | |   |   |         |   | |     | | | |               |
+-+ + +-+-+ +-+-+-+ + + +-+ + +-+ + +-+-+ +-+-+-+ + +-+-+-+ + +-+ + +-+-+-+-+-+-+ +-+-+ +-+ + +-+ + + + +-+-+-+ +-+-+-+-+
|     |   |         | |   |   |   |   |   |   |   | |           | |   |       |     |       |   |       |   |   |   | | |
+ +-+ +-+ +-+-+-+ +-+ + +-+-+-+-+-+ +-+ +-+ +-+-+ + + +-+-+-+-+-+ +-+ + +-+-+-+-+-+-+ +-+-+-+-+-+-+-+-+ + +-+ +-+ +-+ + +
| | | |                 |   |     |   | |   | | | | |     | | |   |   |                 |             |   | |         | |
+ + + +-+-+-+-+-+-+-+-+ + +-+-+ +-+-+ + + +-+ + + + + +-+ + + + +-+ +-+-+-+-+-+-+-+ +-+ +-+-+ +-+-+-+ + +-+ +-+ +-+-+-+ +
|   | | |     |   | |   |     | | |   |   |           |   | | | |       |   | | | |   |       |     | |       | | | | | |
+ +-+ + + +-+-+-+ + +-+ +-+ +-+ + +-+-+-+-+-+-+ +-+ +-+-+ + + + +-+ +-+ +-+ + + + +-+-+-+-+ +-+ +-+-+-+-+-+ +-+ + + + + +
| | | |         |   |   |   |           |   | | | |     |     | | |   |             |       |   |       |     |     |   |
+ + + +-+ +-+ +-+-+ + +-+-+ +-+-+ +-+-+ + +-+ + + + +-+-+-+ +-+ + +-+ +-+ +-+ +-+-+-+-+-+ +-+-+ + +-+-+ +-+-+ +-+-+ + +-+
| | |   | |         | |   | |   |     |           |     |     |   | |   |   | |       | | |   | |     | |       | |   | |
+ + + +-+-+-+ +-+-+ + + +-+ + +-+-+-+-+-+-+-+-+-+-+-+-+-+-+-+-+ +-+ +-+-+-+-+ +-+ +-+ + + + +-+ +-+-+-+ +-+-+-+ + + +-+ +
| | |   |       |   |       |   | | |         | | |         |           |   | | |   | | |   | |   | | | |       | |     |
+ + +-+ +-+-+-+-+-+ +-+-+ +-+-+ + + +-+-+-+-+ + + +-+-+ +-+-+-+-+ +-+-+ +-+ + + +-+ + + + +-+ + +-+ + + +-+-+-+ + +-+-+ +
|     |   | | |       | |   | | |   |                     | | |   | |             | |         |   |         |   | |     |
+-+-+ +-+ + + +-+-+-+ + + +-+ + +-+ +-+-+-+-+-+-+-+-+-+-+ + + +-+ + +-+-+-+-+-+-+-+-+-+-+-+ +-+ +-+ +-+-+-+ +-+ + +-+-+ +
| |     |       | |   | | | |   |       | |   |   |     |     | |   |     | | |     | | |     | | | | |   |   |     |   |
+ +-+-+-+-+ +-+ + +-+ + + + +-+ +-+ +-+ + +-+ +-+ +-+ +-+-+ +-+ +-+ +-+ +-+ + + +-+ + + +-+ +-+ + + + +-+ +-+ +-+ +-+ +-+
| | |   |   |     | |                 |   |             |     |     |   | |   | | |   |   | | |   | | | | | |     |     |
+ + + +-+-+-+ +-+ + + +-+-+-+-+-+-+-+-+-+ +-+-+-+-+-+-+ +-+ +-+-+-+ +-+ + +-+ + + + +-+-+ + + + +-+ + + + + +-+-+-+ +-+-+
| | | | |     | | |       |     | |   |   | | | | |       | |       | | | | | |   |       | |         | |     |         |
+ + + + + +-+ + +-+ +-+-+ +-+-+ + + +-+-+ + + + + +-+-+ +-+ +-+-+ +-+ + + + + +-+-+ +-+ +-+-+-+-+-+ +-+ +-+ +-+-+-+ +-+-+
| |       | |     | | | |   |       |       | |   | |       |   | | | |     |   |     | |   | |     | |       |         |
+ +-+-+-+ + + +-+-+ + + +-+ +-+ +-+ +-+-+-+ + + +-+ +-+-+ +-+ +-+ + + +-+ +-+-+ +-+-+ + +-+ + +-+ +-+ + +-+-+ +-+-+ +-+-+
|     |   |       |       | |     | | | |   | | | | |     | |   |     |   |         | | |   | |     |       | |         |
+-+ +-+-+-+-+-+-+ +-+ +-+-+ + +-+-+ + + + +-+ + + + + +-+ + +-+ + +-+ +-+ +-+-+ +-+ + + +-+ + +-+-+ +-+-+-+ + +-+-+ +-+-+
|   | |   | | |     |   |   | | |   | | |     |   |   | | |   | | |       | |   |   | | | | | |     |   |   |           |
+ +-+ + +-+ + +-+-+-+-+-+ +-+ + +-+ + + + +-+ + +-+ +-+ + + +-+ +-+-+-+-+ + +-+-+ +-+-+ + + + +-+ +-+ +-+-+-+-+-+-+-+-+ +
| |   | | |     |     | |         | |       |           | |         | |     |         | | | |     |     |   | |   | |   |
+ +-+ + + +-+ +-+-+-+ + +-+-+-+-+-+-+-+-+ +-+-+-+-+-+-+-+ + +-+-+-+ + +-+-+ +-+ +-+-+ + + + +-+ +-+-+ +-+ +-+ + +-+ + +-+
|         |   | |       | |     |   |         | |     |     |   | | |   |   |   | |   |   | | |   | |     | | | | | |   |
+ +-+-+-+ + +-+ +-+-+ +-+ +-+-+ +-+ +-+-+ +-+ + +-+-+ +-+ +-+ +-+ + +-+ +-+ +-+ + + +-+ +-+ + +-+ + +-+-+ + + + + + + +-+
|       | |             |   | | | |   |     |     |     | | | | | |           | |     |     | |                 |   |   |
+-+-+-+-+ +-+-+-+-+-+ +-+ +-+ + + + +-+-+-+-+-+ +-+-+-+ + + + + + +-+-+-+ +-+ + +-+-+ +-+-+ + + +-+-+-+-+-+-+-+ + +-+-+ +
|             | | | |   |       |     |   |           |     |     | | | |   |   | | |   | | |       |   |       |     | |
+-+ +-+-+-+-+ + + + +-+ +-+ +-+ +-+-+ + +-+-+-+-+-+-+ +-+-+ + +-+ + + + +-+-+-+ + + + +-+ + +-+ +-+ + +-+ +-+-+ +-+-+ + +
|   | | |   |     | |     |   |   |       |     | | |     |     |         | | | | |   |     |     | |     |   | |       |
+-+ + + +-+ +-+ +-+ + +-+ +-+-+ +-+-+-+-+ +-+-+ + + +-+-+-+-+ +-+-+-+-+-+ + + + + +-+ +-+-+ +-+-+ +-+-+-+ +-+ +-+-+-+-+ +
|   | | |       |       | |           | |     |       |     | |     |     |         | |         |     |   |   | |   |   |
+-+ + + +-+-+ +-+-+-+-+ +-+-+-+ +-+-+ + +-+ +-+ +-+-+ + +-+ + +-+-+ +-+-+-+-+-+-+ +-+ +-+-+-+ +-+-+-+-+ +-+ +-+ +-+ +-+ +
| | | |         |   | | | |         |     | |       |     | |     | |     |   |   |   | |   |   |         |   | | |   | |
+ + + +-+-+-+ +-+-+ + + + +-+-+-+ +-+-+-+-+ + +-+-+ +-+-+-+ + +-+ + +-+ +-+-+ +-+-+-+ + + +-+-+ +-+ +-+-+ + +-+ + +-+ + +
|       |   | |     |         | | | |   |     |     | | |     | |         | | |   |   | |           | |   |     | |     |
+-+-+ +-+ +-+ +-+-+ +-+-+-+ +-+ + + + +-+-+-+-+-+ +-+ + + +-+ + +-+ +-+-+ + + + +-+-+ + +-+-+-+ +-+ + + +-+-+ +-+ +-+-+ +
| | |   | |       |     |       |         |   |     | | |   |   |   | | | |               |       | |     | |           |
+ + +-+ + +-+ +-+-+ +-+ +-+ +-+-+-+-+ +-+ +-+ +-+-+ + + +-+-+-+ +-+ + + +-+-+-+-+-+-+-+-+-+-+-+ +-+-+-+-+ + +-+-+-+-+ +-+
| | | | | |   | |   | | |               |             |   |       | |   | | | | | |                 | |             |   |
+ + + + + + +-+ + +-+ + +-+-+-+ +-+-+-+-+-+ +-+-+-+-+ + +-+-+-+ +-+ +-+ + + + + + + +-+-+-+-+-+-+-+ + +-+-+-+ +-+-+-+-+-+
|         |           |     |   | |     | |       | | |     |     | | | | | |       |           | | |         |   |     |
+-+-+-+-+-+-+ +-+-+-+-+-+-+ + +-+ + +-+ + +-+-+-+ + + + +-+-+ +-+-+ + + + + +-+ +-+ +-+-+ +-+-+ + +-+-+ +-+-+ + +-+ +-+-+
| | | |   |     | | |   |     |       | |         | | |   |       |       |       |   |   |   |   |   | | |   |       | |
+ + + + +-+ +-+ + + + +-+ +-+ + +-+-+-+ +-+-+-+-+ + + + +-+-+-+-+-+-+-+-+-+-+-+-+ +-+ + +-+-+ + +-+-+ + + +-+ + +-+-+-+ +
| |   |     |         |   |   |   |         |       |   |         |   | | |   |     | |   | | | |       |             | |
+ + +-+-+-+-+-+-+-+-+-+ +-+-+-+-+-+-+-+-+-+ + +-+-+-+-+ +-+ +-+-+ +-+ + + + +-+-+ +-+ + +-+ + + +-+-+-+-+ +-+-+-+-+ +-+ +
|   | |     |         | |   | |     |         |                 | |   | |       | |   | | | | | | | |   | | |     |     |
+-+ + +-+-+ + +-+-+-+ + + +-+ +-+ +-+ +-+-+-+-+-+ +-+-+-+-+-+-+-+ + +-+ +-+-+-+ + +-+ + + + + + + + + +-+ + +-+-+ + +-+-+
|   |   |         |   |     |     | |       | |         | |     | |             | | |       |   |     | |       |     | |
+-+ +-+ +-+-+-+-+-+-+ + +-+ +-+ +-+ +-+ +-+ + +-+-+-+-+ + +-+ +-+ +-+-+-+-+ +-+ + + +-+-+-+-+-+ +-+ +-+ +-+-+-+ +-+-+-+ +
| |       |               | |         |   | | |   |   | | |   | | |   |       |   |   | | |         |   |   |       |   |
+ + +-+-+-+-+ +-+-+-+-+-+-+ +-+-+-+-+ +-+-+ + + +-+ +-+ + +-+ + + + +-+ +-+-+-+-+ + +-+ + + +-+-+-+ + +-+-+ +-+-+ +-+ +-+
| | |         |   |   | |   |   |   |   | | |   |   |       | | |     | | |           |         |             |   |   | |
+ + + +-+-+-+ + +-+-+ + + +-+-+ +-+ +-+ + + +-+ + +-+ +-+-+ + + +-+ +-+ + +-+-+ +-+-+ +-+-+-+-+-+-+-+-+-+-+-+-+-+ +-+ + +
| |   |     |         | |       |   |   |       | | |     | |   |     | | |   |     |   |   | | | |             |       |
+ + +-+ +-+ +-+-+-+-+ + + +-+-+ + +-+ +-+-+-+ +-+ + +-+-+-+ + +-+ +-+-+ + + +-+-+ +-+-+ + +-+ + + +-+-+-+-+ +-+ +-+ +-+-+
| |       | |           |     | |                       |       | | |     | |     |     |   |       |   |     |         |
+ +-+-+-+-+-+-+-+-+-+-+-+-+-+-+-+-+-+-+-+ +-+-+-+-+-+-+-+-+-+-+-+ + + +-+ + +-+ +-+-+-+ +-+ +-+-+ +-+-+ +-+-+-+-+-+-+ +-+
|   |   |             |       |       |   |   |             |   | | |   | | | |       | |       | |     |   | | |       |
+ +-+ +-+-+-+-+-+ +-+ + +-+-+ + +-+-+ +-+ +-+ +-+-+-+-+ +-+ +-+ + + +-+-+ + + + +-+-+-+ +-+ +-+ + + +-+ + +-+ + +-+-+ +-+
|     | | |     | | |       | | |             |   |       | | |     | |     |   | |     | |   | |     | | |   | |   | | |
+ +-+ + + +-+-+ + + +-+ +-+-+ +-+-+-+-+-+ +-+ +-+ +-+ +-+-+ + +-+ +-+ +-+ +-+-+ + +-+-+ + + +-+ +-+ +-+ + + +-+ + +-+ + +
|   |             |   | |   |   |           |   | |   | |   | |     |   | |       |   |   |   | |     |   |   |     | | |
+-+-+-+-+ +-+-+-+ +-+ + + +-+ +-+-+-+-+-+-+-+-+ + +-+ + +-+ + + +-+ + +-+ +-+-+-+ + +-+ +-+ +-+ + +-+-+-+ + +-+-+-+ + + +
|         | |     |     |   | |             |   |   |     |   |   |   |   |   | |   | |       | |   |   |     |     |   |
+-+ +-+-+ + +-+-+-+ +-+ + +-+ +-+-+-+-+-+-+ +-+ +-+ +-+ +-+-+ +-+-+-+-+-+ +-+ + + +-+ + +-+-+-+ +-+ +-+ +-+-+ +-+ +-+ +-+
|   |           |   |   |   | | | |   | |         | |       |   | |       |         |         | |     | | | | |         |
+ +-+ +-+-+-+-+-+-+-+-+ +-+ + + + +-+ + +-+ +-+-+ + +-+-+-+-+ +-+ +-+-+ +-+-+-+-+-+-+-+-+-+-+-+ + +-+ + + + + +-+ +-+-+-+
|   |                 |     | |           |   |         |     |             |       |     |   |     |       |   |       |
+-+-+-+-+-+-+-+-+-+-+-+-+ +-+ +-+-+-+-+ +-+-+-+-+-+ +-+ + +-+ +-+-+-+-+ +-+ +-+ +-+ +-+-+ + +-+-+-+-+-+-+-+-+-+-+-+-+ +-+
|           |       | | | |   |       | |       | |   |     |     | |     |       |   | |     |       |     | |     |   |
+-+-+-+ +-+ + +-+-+ + + +-+ +-+-+-+-+ + +-+-+-+ + +-+-+-+-+ +-+-+ + +-+ +-+-+-+-+-+-+ + + +-+ +-+-+ +-+ +-+ + + +-+ +-+ +
|       |   |     |       |           | |           | | | | |   | | |     | | |         | |   | | |   |   | | |   |     |
+-+-+-+ +-+ +-+-+-+-+-+-+ +-+-+-+ +-+ + +-+-+ +-+-+ + + + + +-+ + + +-+ +-+ + +-+-+-+-+ + +-+ + + +-+ + +-+ + +-+-+ +-+-+
|       |                         |               |             |     |               |     |             | |           |
+-+-+-+-+-+-+-+-+-+-+-+-+-+-+-+-+-+-+-+-+-+-+-+-+-+-+-+-+-+-+-+-+-+-+-+-+-+-+-+-+-+-+-+-+-+-+-+-+-+-+-+-+-+-+-+-+-+-+-+-+