+-+-+-+-+-+-+-+-+-+-+-+-+-+-+-+-+-+-+-+-+-+-+
|             |   |   | |             | | | |
+-+-+-+ +-+-+ + +-+ +-+ +-+-+ +-+-+-+ + + + +
| |   | |   | | |   |   |     | | |   |   | |
+ +-+ + + +-+ + +-+ + +-+-+-+ + + +-+ +-+ + +
| | |       |   |   |   |         |   |     |
+ + +-+ +-+ +-+ + +-+-+ +-+-+-+-+-+ +-+ +-+-+
|         | | |   |       | |   | | | |   | |
+-+-+-+ +-+ + +-+ +-+-+-+ + +-+ + + + + +-+ +
|   | |   |   | |         |   | | |     |   |
+ +-+ + +-+-+ + +-+-+-+ +-+ +-+ + +-+ +-+-+ +
|     | | | |   | | | |         |   | | | | |
+ +-+ + + + + +-+ + + +-+-+-+-+ +-+ + + + + +
| | |   |   |         |   | |   |   |   | | |
+ + +-+ + +-+-+-+ +-+-+-+ + + +-+-+ + +-+ + +
|   | |   | |   | | | |     |     | |   |   |
+-+ + + +-+ +-+ + + + +-+ +-+ +-+ + + +-+-+ +
|   |           |   | | | | | |   |   |     |
+-+-+-+ +-+-+-+-+-+-+ + + + +-+-+ + +-+-+ +-+
|   |     |   | |   | | | |     | |   |   | |
+ +-+-+-+ + +-+ +-+ + + + +-+ +-+ + +-+ +-+ +
|   | |     | |     |   |     |     | |     |
+ +-+ + +-+ + + +-+ + +-+ +-+ + +-+ + + +-+-+
|   |   | | | | |   |   | |       | | |   | |
+ +-+-+ + + + +-+-+ + +-+-+-+ +-+-+ + +-+ + +
| |       |     |     | | |     |       |   |
+ +-+-+-+-+-+-+ + +-+ + + +-+ +-+-+ +-+ + +-+
| |     |   | | | |     |   | | |   |     | |
+ +-+-+ +-+ + + + + +-+ + +-+ + +-+ +-+-+-+ +
| |     |   |     | |   |     |   |     | | |
+ +-+ +-+-+ +-+-+-+-+-+ +-+-+-+-+ +-+-+ + + +
| | |       | |       | |       | |         |
+ + + +-+-+ + +-+ +-+ + +-+-+-+ + +-+-+-+ +-+
|       |   | |     | |   |   |     | | |   |
+ +-+-+-+-+-+ + +-+-+-+ +-+-+ + +-+ + + +-+ +
| |   |     | | |   |   |   | |   |   |     |
+ +-+ + +-+ + + + +-+-+ +-+ + +-+-+ +-+-+-+ +
|         |                           |     |
+-+-+-+-+-+-+-+-+-+-+-+-+-+-+-+-+-+-+-+-+-+-+
